ВКЛ	ВКЛ	NP_top_country:n:sNGDAIL
БНР	БНР	NP_top_country:f:sNGDAIL
БССР	БССР	NP_top_country:f:sNGDAIL
РБ	РБ	NP_top_country:f:sNGDAIL
РФ	РФ	NP_top_country:f:sNGDAIL
ЗША	ЗША	NP_top_country:0:pNGDAIL
КНР	КНР	NP_top_country:f:sNGDAIL
РСФСР	РСФСР	NP_top_country:m:sNGDAIL
СССР	СССР	NP_top_country:m:sNGDAIL
УССР	УССР	NP_top_country:f:sNGDAIL
ФРГ	ФРГ	NP_top_country:f:sNGDAIL
ГДР	ГДР	NP_top_country:f:sNGDAIL

Чылі	Чылі	NP_top_country:f:sNGDAIL
Зімбабвэ	Зімбабвэ	NP_top_country:f:sNGDAIL
Конга	Конга	NP_top_country:n:sNGDAIL
Кохтла-Ярве	Кохтла-Ярве	NP_top_stl:town:m:sNGDAIL
Маарду	Маарду	NP_top_stl:town:m:sNGDAIL
Тарту	Тарту	NP_top_stl:town:m:sNGDAIL
Тальяці	Тальяці	NP_top_stl:town:m:sNGDAIL
Алматы	Алматы	NP_top_stl:town:m:sNGDAIL
Хельсінкі	Хельсінкі	NP_top_stl:town:m:sNGDAIL
Сочы	Сочы	NP_top_stl:town:m:sNGDAIL
Акапулька	Акапулька	NP_top_stl:town:m:sNGDAIL
Осла	Осла	NP_top_stl:town:m:sNGDAIL
Тбілісі	Тбілісі	NP_top_stl:town:m:sNGDAIL
Цхінвалі	Цхінвалі	NP_top_stl:town:m:sNGDAIL
Мумбаі	Мумбаі	NP_top_stl:town:m:sNGDAIL
Чыкага	Чыкага	NP_top_stl:town:m:sNGDAIL
Токіа	Токіа	NP_top_stl:town:m:sNGDAIL
Таронта	Таронта	NP_top_stl:town:m:sNGDAIL
Монтэ-Карла	Монтэ-Карла	NP_top_stl:town:m:sNGDAIL
Абу-Дабі	Абу-Дабі	NP_top_stl:town:m:sNGDAIL
Каларада	Каларада	NP_top_distr:m:sNGDAIL

Днепр	Днепр	NP_top_river:m:sNA
Дняпро	Дняпро	NP_top_river:m:sNA
Дняпра	Днепр	NP_top_river:m:sG
Дняпра	Дняпро	NP_top_river:m:sG
Дняпру	Днепр	NP_top_river:m:sD
Дняпру	Дняпро	NP_top_river:m:sD
Дняпром	Днепр	NP_top_river:m:sI
Дняпром	Дняпро	NP_top_river:m:sI
Дняпры	Днепр	NP_top_river:m:sL
Дняпры	Дняпро	NP_top_river:m:sL
Сібір	Сібір	NP_top_reg:f:sNA
Сібіры	Сібір	NP_top_reg:f:sGDL
Сібір'ю	Сібір	NP_top_reg:f:sI