абжытку	абжытак	N:m:sG
абжытак	абжытак	N:m:sA
абзаводку	абзаводак	N:m:sG
абзаводак	абзаводак	N:m:sA
аднавор	аднавор	N:m:sA
адыходак	адыходак	N:m:sA
брудэршафт	брудэршафт	N:m:sA
дварэ	двор	N:m:sL
дыхту	дыхт	N:m:sG
заваду	завад	N:m:sG
кірмаша	кірмаш	N:m:sG
конт	конт	N:m:sA
манер	манер	N:m:sA
манерам	манер	N:m:sI
падпітку	падпітак	N:m:sL
панталыку	панталык	N:m:sG
панюх	панюх	N:m:sA
плаве	плаў	N:m:sL
пражытак	пражытак	N:m:sA
просыпу	просып	N:m:sG
прывіда	прывід	N:m:sG
прыліку	прылік	N:m:sG
пярэсыпу	пярэсып	N:m:sG
седнем	седзень	N:m:sI
тропу	троп	N:m:sG
угамону	угамон	N:m:sG
унімку	унімак	N:m:sG
упаду	упад	N:m:sG
халт	халт	N:m:sA
ходырам	ходыр	N:m:sI
храпака	храпак	N:m:sG
храпунца	храпунец	N:m:sG
цыгундар	цыгундар	N:m:sA
цямка	цямок	N:m:sG
цямочку	цямочак	N:m:sG
чосу	чос	N:m:sG

антымоніі	антымонія	N:f:pA
асанну	асанна	N:f:sA
бесцань	бесцань	N:f:sA
музыкай	музыка	N:f:sI
начы	ноч	N:f:sL
паўсмерці	паўсмерць	N:f:sG
поўху	поўха	N:f:sA
рэшт	рэшта	N:f:pG
соллю	соль	N:f:sI
фору	фора	N:f:sA
цацанка	цацанка	N:f:sN
цюцелька	цюцелька	N:f:sN
цюцельку	цюцелька	N:f:sA
чаканкі	чаканка	N:f:sG
шкірку	шкірка	N:f:sA

пражыццё	пражыццё	N:n:sA
спатыкнення	спатыкненне	N:n:sG
адхлання	адхланне	N:n:sG

дыбачкі	дыбачкі	N:0:pA
дыбачках	дыбачкі	N:0:pL
дыбкі	дыбкі	N:0:pA
дыбы	дыбы	N:0:pA
лынды	лынды	N:0:pA
лясы	лясы	N:0:pA
мігі	мігі	N:0:pA
мігах	мігі	N:0:pL
пабягушках	пабягушкі	N:0:pL
пярэймы	пярэймы	N:0:pA
цыпачкі	цыпачкі	N:0:pA
цыпачках	цыпачкі	N:0:pL
цыпкі	цыпкі	N:0:pA
цыпках	цыпкі	N:0:pL

лататы	лататы	N:0:pA

першакласніцаў	першакласніца	N:f:pGA
другакласніцаў	другакласніца	N:f:pGA
трэцякласніцаў	трэцякласніца	N:f:pGA
чацвёртакласніцаў	чацвёртакласніца	N:f:pGA
пяцікласніцаў	пяцікласніца	N:f:pGA
шасцікласніцаў	шасцікласніца	N:f:pGA
сямікласніцаў	сямікласніца	N:f:pGA
васьмікласніцаў	васьмікласніца	N:f:pGA
дзевяцікласніцаў	дзевяцікласніца	N:f:pGA
дзесяцікласніцаў	дзесяцікласніца	N:f:pGA
адзінаццацікласніцаў	адзінаццацікласніца	N:f:pGA

аб'яваў	аб'ява	N:f:pG
авантураў	авантура	N:f:pG
адзнакаў	адзнака	N:f:pG
аліўкаў	аліўка	N:f:pG
амфараў	амфара	N:f:pG
аркебузаў	аркебуза	N:f:pG
асінаў	асіна	N:f:pG
байніцаў	байніца	N:f:pG
барыкадаў	барыкада	N:f:pG
бібліятэкаў	бібліятэка	N:f:pG
брамаў	брама	N:f:pG
брашураў	брашура	N:f:pG
брусніцаў	брусніца	N:f:pG
бярозаў	бяроза	N:f:pG
бяседаў	бяседа	N:f:pG
венаў	вена	N:f:pG
візаў	віза	N:f:pG
вітрынаў	вітрына	N:f:pG
вуліцаў	вуліца	N:f:pG
высноваў	выснова	N:f:pG
выставаў	выстава	N:f:pG
выяваў	выява	N:f:pG
выяў	выява	N:f:pG
гадзінаў	гадзіна	N:f:pG
гарматаў	гармата	N:f:pG
глыбаў	глыба	N:f:pG
гранатаў	граната	N:f:pG
дзідаў	дзіда	N:f:pG
дозаў	доза	N:f:pG
драбніцаў	драбніца	N:f:pG
дуброваў	дуброва	N:f:pG
журавінаў	журавіна	N:f:pG
забаронаў	забарона	N:f:pG
заганаў	загана	N:f:pG
заўвагаў	заўвага	N:f:pG
згрызотаў	згрызота	N:f:pG
здрадаў	здрада	N:f:pG
зменаў	змена	N:f:pG
зонаў	зона	N:f:pG
каардынатаў	каардыната	N:f:pG
каляінаў	каляіна	N:f:pG
кантораў	кантора	N:f:pG
карцінаў	карціна	N:f:pG
касаў	каса	N:f:pG
катлетаў	катлета	N:f:pG
кватэраў	кватэра	N:f:pG
кнігаў	кніга	N:f:pG
краінаў	краіна	N:f:pG
крыніцаў	крыніца	N:f:pG
крыўдаў	крыўда	N:f:pG
кулісаў	куліса	N:f:pG
ліпаў	ліпа	N:f:pG
лужынаў	лужына	N:f:pG
магілаў	магіла	N:f:pG
манетаў	манета	N:f:pG
мараў	мара	N:f:pG
маслінаў	масліна	N:f:pG
метафараў	метафара	N:f:pG
мікстураў	мікстура	N:f:pG
моваў	мова	N:f:pG
мэтаў	мэта	N:f:pG
мясцінаў	мясціна	N:f:pG
пагрозаў	пагроза	N:f:pG
падковаў	падкова	N:f:pG
падставаў	падстава	N:f:pG
пакутаў	пакута	N:f:pG
папяросаў	папяроса	N:f:pG
параў	пара	N:f:pG
патрэбаў	патрэба	N:f:pG
паэмаў	паэма	N:f:pG
перавагаў	перавага	N:f:pG
перадачаў	перадача	N:f:pG
пераменаў	перамена	N:f:pG
перашкодаў	перашкода	N:f:pG
пірамідаў	піраміда	N:f:pG
плямаў	пляма	N:f:pG
пошлінаў	пошліна	N:f:pG
праблемаў	праблема	N:f:pG
прамоваў	прамова	N:f:pG
прапановаў	прапанова	N:f:pG
праўдаў	праўда	N:f:pG
працаў	праца	N:f:pG
працэдураў	працэдура	N:f:pG
прыгодаў	прыгода	N:f:pG
прыкметаў	прыкмета	N:f:pG
прыладаў	прылада	N:f:pG
прычынаў	прычына	N:f:pG
развагаў	развага	N:f:pG
размоваў	размова	N:f:pG
ранаў	рана	N:f:pG
раслінаў	расліна	N:f:pG
ружаў	ружа	N:f:pG
справаў	справа	N:f:pG
спробаў	спроба	N:f:pG
стратаў	страта	N:f:pG
структураў	структура	N:f:pG
суніцаў	суніца	N:f:pG
сустрэчаў	сустрэча	N:f:pG
сфераў	сфера	N:f:pG
схемаў	схема	N:f:pG
сядзібаў	сядзіба	N:f:pG
тканінаў	тканіна	N:f:pG
трубаў	труба	N:f:pG
трэшчынаў	трэшчына	N:f:pG
турботаў	турбота	N:f:pG
тысячаў	тысяча	N:f:pG
тэлекамераў	тэлекамера	N:f:pG
тэмаў	тэма	N:f:pG
умоваў	умова	N:f:pG
установаў	установа	N:f:pG
хваробаў	хвароба	N:f:pG
хвілінаў	хвіліна	N:f:pG
цыгарэтаў	цыгарэта	N:f:pG
цямніцаў	цямніца	N:f:pG
чарніцаў	чарніца	N:f:pG
школаў	школа	N:f:pG
штораў	штора	N:f:pG
шчылінаў	шчыліна	N:f:pG
эпохаў	эпоха	N:f:pG
ягадаў	ягада	N:f:pG
машынаў	машына	N:f:pG
забаваў	забава	N:f:pG
газетаў	газета	N:f:pG
папераў	папера	N:f:pG
галінаў	галіна	N:f:pG
таямніцаў	таямніца	N:f:pG
хмараў	хмара	N:f:pG
дзюнаў	дзюна	N:f:pG
маршчынаў	маршчына	N:f:pG
камяніцаў	камяніца	N:f:pG
фразаў	фраза	N:f:pG
бедаў	бяда	N:f:pG
каўбасаў	каўбаса	N:f:pG
межаў	мяжа	N:f:pG
навінаў	навіна	N:f:pG
плітаў	пліта	N:f:pG
скалаў	скала	N:f:pG
сценаў	сцяна	N:f:pG
цэнаў	цана	N:f:pG
шыротаў	шырата	N:f:pG
вяршыняў	вяршыня	N:f:pG
велічыняў	велічыня	N:f:pG
земляў	зямля	N:f:pG
скрыняў	скрыня	N:f:pG
хвояў	хвоя	N:f:pG
эмоцыяў	эмоцыя	N:f:pG
жменяў	жменя	N:f:pG
хваляў	хваля	N:f:pG
традыцыяў	традыцыя	N:f:pG
кухняў	кухня	N:f:pG
персіярняў	персіярня	N:f:pG
песняў	песня	N:f:pG
вышыняў	вышыня	N:f:pG
глыбіняў	глыбіня	N:f:pG
падзеяў	падзея	N:f:pG
акцыяў	акцыя	N:f:pG
ілюзіяў	ілюзія	N:f:pG
кампаніяў	кампанія	N:f:pG
вакацыяў	вакацыя	N:f:pG
прэтэнзіяў	прэтэнзія	N:f:pG
пазіцыяў	пазіцыя	N:f:pG
батарэяў	батарэя	N:f:pG
прэміяў	прэмія	N:f:pG
рэстарацыяў	рэстарацыя	N:f:pG
калекцыяў	калекцыя	N:f:pG
лекцыяў	лекцыя	N:f:pG
дэкарацыяў	дэкарацыя	N:f:pG
вяргіняў	вяргіня	N:f:pG
кашуляў	кашуля	N:f:pG
яблыняў	яблыня	N:f:pG
адметнасцяў	адметнасць	N:f:pG
акалічнасцяў	акалічнасць	N:f:pG
аповесцяў	аповесць	N:f:pG
асаблівасцяў	асаблівасць	N:f:pG
вольнасцяў	вольнасць	N:f:pG
вытворчасцяў	вытворчасць	N:f:pG
дамоўленасцяў	дамоўленасць	N:f:pG
дробязяў	дробязь	N:f:pG
жорсткасцяў	жорсткасць	N:f:pG
здольнасцяў	здольнасць	N:f:pG
канечнасцяў	канечнасць	N:f:pG
каштоўнасцяў	каштоўнасць	N:f:pG
якасцяў	якасць	N:f:pG
цяжкасцяў	цяжкасць	N:f:pG
супольнасцяў	супольнасць	N:f:pG
тонкасцяў	тонкасць	N:f:pG
узаемасувязяў	узаемасувязь	N:f:pG
урачыстасцяў	урачыстасць	N:f:pG
крэпасцяў	крэпасць	N:f:pG
магутнасцяў	магутнасць	N:f:pG
магчымасцяў	магчымасць	N:f:pG
меншасцяў	меншасць	N:f:pG
мясцовасцяў	мясцовасць	N:f:pG
народнасцяў	народнасць	N:f:pG
нацыянальнасцяў	нацыянальнасць	N:f:pG
немагчымасцяў	немагчымасць	N:f:pG
непрыемнасцяў	непрыемнасць	N:f:pG
нечаканасцяў	нечаканасць	N:f:pG
нязручнасцяў	нязручнасць	N:f:pG
панэляў	панэль	N:f:pG
паралеляў	паралель	N:f:pG
прывабнасцяў	прывабнасць	N:f:pG
прыхільнасцяў	прыхільнасць	N:f:pG
спецыяльнасцяў	спецыяльнасць	N:f:pG
старажытнасцяў	старажытнасць	N:f:pG
славутасцяў	славутасць	N:f:pG
уласцівасцяў	уласцівасць	N:f:pG
жарсцяў	жарсць	N:f:pG
споведзяў	споведзь	N:f:pG
выпадковасцяў	выпадковасць	N:f:pG
вадкасцяў	вадкасць	N:f:pG
адлегласцяў	адлегласць	N:f:pG
вартасцяў	вартасць	N:f:pG
ведамасцяў	ведамасць	N:f:pG
водарасцяў	водарасць	N:f:pG
даверанасцяў	даверанасць	N:f:pG
ёмістасцяў	ёмістасць	N:f:pG
няспраўнасцяў	няспраўнасць	N:f:pG
павіннасцяў	павіннасць	N:f:pG
падрабязнасцяў	падрабязнасць	N:f:pG
патрэбнасцяў	патрэбнасць	N:f:pG
поласцяў	поласць	N:f:pG
пошасцяў	пошасць	N:f:pG
правіннасцяў	правіннасць	N:f:pG
радасцяў	радасць	N:f:pG
судзімасцяў	судзімасць	N:f:pG
супярэчнасцяў	супярэчнасць	N:f:pG
схільнасцяў	схільнасць	N:f:pG
умоўнасцяў	умоўнасць	N:f:pG
фармальнасцяў	фармальнасць	N:f:pG
хуткасцяў	хуткасць	N:f:pG
аканечнасцяў	аканечнасць	N:f:pG

асобаў	асоба	N:f:pGA
ахвяраў	ахвяра	N:f:pGA
варонаў	варона	N:f:pGA
жабаў	жаба	N:f:pGA
жанчынаў	жанчына	N:f:pGA
жывёлаў	жывёла	N:f:pGA
жывёлінаў	жывёліна	N:f:pGA
істотаў	істота	N:f:pGA
кабетаў	кабета	N:f:pGA
кабылаў	кабыла	N:f:pGA
пачвараў	пачвара	N:f:pGA
пчолаў	пчала	N:f:pGa
стракозаў	страказа	N:f:pGA
бабуляў	бабуля	N:f:pGA
гаспадыняў	гаспадыня	N:f:pGA
феяў	фея	N:f:pGA
матуляў	матуля	N:f:pGA
прыгажуняў	прыгажуня	N:f:pGA
знакамітасцяў	знакамітасць	N:f:pGA
постацяў	постаць	N:f:pGA

абменаў	абмен	N:m:pG
абярэгаў	абярэг	N:m:pG
адсоткаў	адсотак	N:m:pG
арбузаў	арбуз	N:m:pG
векселяў	вексель	N:m:pG
вулляў	вулей	N:m:pG
даляраў	даляр	N:m:pG
дзясяткаў	дзясятак	N:m:pG
коштаў	кошт	N:m:pG
лёсаў	лёс	N:m:pG
накірункаў	накірунак	N:m:pG
продажаў	продаж	N:m:pG
прыярытэтаў	прыярытэт	N:m:pG
сапрапеляў	сапрапель	N:m:pG
складнікаў	складнік	N:m:pG
слаёў	слой	N:m:pG
стасункаў	стасунак	N:m:pG
суіцыдаў	суіцыд	N:m:pG
тунэляў	тунэль	N:m:pG
экземпляраў	экземпляр	N:m:pG
этнасаў	этнас	N:m:pG
настрояў	настрой	N:m:pG
фатэляў	фатэль	N:m:pG

баяраў	баярын	N:m:pGA
вояў	вой	N:m:pGA
гараджанаў	гараджанін	N:m:pGA
грамадзянаў	грамадзянін	N:m:pGA
дзядуляў	дзядуля	N:m:pGA
замежнікаў	замежнік	N:m:pGA
казахстанцаў	казахстанец	N:m:pGA
касінераў	касінер	N:m:pGA
купалаўцаў	купалавец	N:m:pGA
луняў	лунь	N:m:pGA
лучнікаў	лучнік	N:m:pGA
мужчынаў	мужчына	N:m:pGA
падарожнікаў	падарожнік	N:m:pGA
пачаткоўцаў	пачатковец	N:m:pGA
працадаўцаў	працадаўца	N:m:pGA
распрацоўшчыкаў	распрацоўшчык	N:m:pGA
салдатаў	салдат	N:m:pGA
старшыняў	старшыня	N:m:pGA
супернікаў	супернік	N:m:pGA
тальяцінцаў	тальяцінец	N:m:pGA
чалавекаў	чалавек	N:m:pGA
злодзеяў	злодзей	N:m:pGA
суграмадзянаў	суграмадзянін	N:m:pGA
наведнікаў	наведнік	N:m:pGA
амапаўцаў	амапавец	N:m:pGA
мяшчанаў	мешчанін	N:m:pGA
ваяводаў	ваявода	N:m:pGA
прыхадняў	прыхадзень	N:m:pGA

азарэнняў	азарэнне	N:n:pG
балотаў	балота	N:n:pG
вылячэнняў	вылячэнне	N:n:pG
даследванняў	даследванне	N:n:pG
жыццяў	жыццё	N:n:pG
зацікаўленняў	зацікаўленне	N:n:pG
звальненняў	звальненне	N:n:pG
згадванняў	згадванне	N:n:pG
здзіўленняў	здзіўленне	N:n:pG
змаганняў	змаганне	N:n:pG
змяненняў	змяненне	N:n:pG
значэнняў	значэнне	N:n:pG
катаванняў	катаванне	N:n:pG
мастацтваў	мастацтва	N:n:pG
месцапражыванняў	месцапражыванне	N:n:pG
напружанняў	напружанне	N:n:pG
новаўвядзенняў	новаўвядзенне	N:n:pG
пераабсталяванняў	пераабсталяванне	N:n:pG
прысвячэнняў	прысвячэнне	N:n:pG
расследаванняў	расследаванне	N:n:pG
самазабойстваў	самазабойства	N:n:pG
сацапытанняў	сацапытанне	N:n:pG
святаў	свята	N:n:pG
святкаванняў	святкаванне	N:n:pG
словаў	слова	N:n:pG
спачуванняў	спачуванне	N:n:pG
узыходжанняў	узыходжанне	N:n:pG
умяшанняў	умяшанне	N:n:pG
ускладненняў	ускладненне	N:n:pG
целаў	цела	N:n:pG
рознагалоссяў	рознагалоссе	N:n:pG
узрушэнняў	узрушэнне	N:n:pG
бярвёнаў	бервяно	N:n:pG
бярвенняў	бервяно	N:n:pG

кацянятаў	кацяня	N:n:pGA
птушанятаў	птушаня	N:n:pGA

шахматаў	шахматы	N:0:pG
абставінаў	абставіны	N:0:pG
адносінаў	адносіны	N:0:pG
зносінаў	зносіны	N:0:pG
перамоваў	перамовы	N:0:pG
паводзінаў	паводзіны	N:0:pG
узаемаадносінаў	узаемаадносіны	N:0:pG
абдоймаў	абдоймы	N:0:pG
варотцаў	варотцы	N:0:pG
парэшткаў	парэшткі	N:0:pG


паўбохана	паўбохана	N:m:sNGDAIL
паўвека	паўвека	N:m:sNGDAIL
паўвоза	паўвоза	N:m:sNGDAIL
паўвяршка	паўвяршка	N:m:sNGDAIL
паўгектара	паўгектара	N:m:sNGDAIL
паўгода	паўгода	N:m:sNGDAIL
паўгорада	паўгорада	N:m:sNGDAIL
паўдзесятка	паўдзесятка	N:m:sNGDAIL
паўдзясятка	паўдзясятка	N:m:sNGDAIL
паўдня	паўдня	N:m:sNGDAIL
паўдома	паўдома	N:m:sNGDAIL
паўзаробку	паўзаробку	N:m:sNGDAIL
паўкілаграма	паўкілаграма	N:m:sNGDAIL
паўкіламетра	паўкіламетра	N:m:sNGDAIL
паўметра	паўметра	N:m:sNGDAIL
паўмільёна	паўмільёна	N:m:sNGDAIL
паўмільярда	паўмільярда	N:m:sNGDAIL
паўпакета	паўпакета	N:m:sNGDAIL
паўпрацэнта	паўпрацэнта	N:m:sNGDAIL
паўтрактара	паўтрактара	N:m:sNGDAIL
паўтрыльёна	паўтрыльёна	N:m:sNGDAIL
паўтузіна	паўтузіна	N:m:sNGDAIL

паўбулачкі	паўбулачкі	N:f:sNGDAIL
паўбуханкі	паўбуханкі	N:f:sNGDAIL
паўбяды	паўбяды	N:f:sNGDAIL
паўвёскі	паўвёскі	N:f:sNGDAIL
паўгадзінкі	паўгадзінкі	N:f:sNGDAIL
паўгадзіны	паўгадзіны	N:f:sNGDAIL
паўгрупы	паўгрупы	N:f:sNGDAIL
паўдарогі	паўдарогі	N:f:sNGDAIL
паўдзяржавы	паўдзяржавы	N:f:sNGDAIL
паўзямлянкі	паўзямлянкі	N:f:sNGDAIL
паўкраіны	паўкраіны	N:f:sNGDAIL
паўлядоўні	паўлядоўні	N:f:sNGDAIL
паўпавеці	паўпавеці	N:f:sNGDAIL
паўпенсіі	паўпенсіі	N:f:sNGDAIL
паўпляшкі	паўпляшкі	N:f:sNGDAIL
паўсвінні	паўсвінні	N:f:sNGDAIL
паўсекунды	паўсекунды	N:f:sNGDAIL
паўсправы	паўсправы	N:f:sNGDAIL
паўстаронкі	паўстаронкі	N:f:sNGDAIL
паўстаўкі	паўстаўкі	N:f:sNGDAIL
паўтысячы	паўтысячы	N:f:sNGDAIL
паўхвілі	паўхвілі	N:f:sNGDAIL
паўцаны	паўцаны	N:f:sNGDAIL
паўшклянкі	паўшклянкі	N:f:sNGDAIL

паўкрыла	паўкрыла	N:n:sNGDAIL
паўстагоддзя	паўстагоддзя	N:n:sNGDAIL
паўкіло	паўкіло	N:n:sNGDAIL

паўсанак	паўсанак	N:0:pNGDAIL
паўсутак	паўсутак	N:0:pNGDAIL


этапа	этап	N:m:sG
гурта	гурт	N:m:sG
раза	раз	N:m:sG
дыялога	дыялог	N:m:sG
штата	штат	N:m:sG
ельніка	ельнік	N:m:sG
мемарыяла	мемарыял	N:m:sG
патэнцыяла	патэнцыял	N:m:sG
даклада	даклад	N:m:sG

даланёй	далонь	N:f:sI
спіной	спіна	N:f:sI

бервяны	бервяно	N:m:pNA

кропель	кропля	N:f:pG

вачмі	вока	N:n:pI
вачох	вока	N:n:pL

крыллі	крыло	N:n:pNA
крылляў	крыло	N:n:pG
крыллям	крыло	N:n:pD
крыллямі	крыло	N:n:pI
крыллях	крыло	N:n:pL

пане	пан	N:m:sV
панове	пан	N:m:pV
божа	бог	N:m:sV
ойча	айцец	N:m:sV
дружа	друг	N:m:sV
хлопча	хлопец	N:m:sV
панічыку	панічык	N:m:sV