безумоўна	безумоўна	Mod
бясспрэчна	бясспрэчна	Mod
ведама	ведама	Mod
відавочна	відавочна	Mod
відаць	відаць	Mod
відна	відна	Mod
вядома	вядома	Mod
гавораць	гаварыць	Mod
дарэчы	дарэчы	Mod
здавалася	здавацца	Mod
здаецца	здавацца	Mod
значыцца	значыцца	Mod
значыць	значыць	Mod
зразумела	зразумела	Mod
зрэшты	зрэшты	Mod
кажуць	казаць	Mod
канечне	канечне	Mod
канешне	канешне	Mod
мабыць	мабыць	Mod
магчыма	магчыма	Mod
мажліва	мажліва	Mod
мо	мо	Mod
можа	можа	Mod
мусібыць	мусібыць	Mod
мусіць	мусіць	Mod
наадварот	наадварот	Mod
наогул	наогул	Mod
напрыклад	напрыклад	Mod
напэўна	напэўна	Mod
нарэшце	нарэшце	Mod
насамрэч	насамрэч	Mod
несумненна	несумненна	Mod
па-восьмае	па-восьмае	Mod
па-дзявятае	па-дзявятае	Mod
па-дзясятае	па-дзясятае	Mod
па-другое	па-другое	Mod
па-першае	па-першае	Mod
па-пятае	па-пятае	Mod
па-сёмае	па-сёмае	Mod
па-трэцяе	па-трэцяе	Mod
па-чацвёртае	па-чацвёртае	Mod
па-шостае	па-шостае	Mod
пішуць	пісаць	Mod
праўда	праўда	Mod
прынамсі	прынамсі	Mod
пэўна	пэўна	Mod
распавядаюць	распавядаць	Mod
сапраўды	сапраўды	Mod