Вазары	Вазары	NP_surn:m:sNGDAIL
Вердзі	Вердзі	NP_surn:m:sNGDAIL
Гейнэ	Гейнэ	NP_surn:m:sNGDAIL
Гётэ	Гётэ	NP_surn:m:sNGDAIL
Гурло	Гурло	NP_surn:m:sNGDAIL
Жудро	Жудро	NP_surn:m:sNGDAIL
Марці	Марці	NP_surn:m:sNGDAIL
Саакашвілі	Саакашвілі	NP_surn:m:sNGDAIL
Сарказі	Сарказі	NP_surn:m:sNGDAIL
Цыскарыдзе	Цыскарыдзе	NP_surn:m:sNGDAIL
Штанге	Штанге	NP_surn:m:sNGDAIL
Экзюперы	Экзюперы	NP_surn:m:sNGDAIL

Арабей	Арабей	NP_surn:f:sNGDAIL
Бічэль	Бічэль	NP_surn:f:sNGDAIL
Варлей	Варлей	NP_surn:f:sNGDAIL
Дункан	Дункан	NP_surn:f:sNGDAIL
Кабалье	Кабалье	NP_surn:f:sNGDAIL
Куцкайтэ	Куцкайтэ	NP_surn:f:sNGDAIL
Ліндгрэн	Ліндгрэн	NP_surn:f:sNGDAIL
Немагай	Немагай	NP_surn:f:sNGDAIL

Бажко	Бажко	NP_surn:m:sNGDAIL
Бажко	Бажко	NP_surn:f:sNGDAIL
Ганько	Ганько	NP_surn:m:sNGDAIL
Ганько	Ганько	NP_surn:f:sNGDAIL
Грынько	Грынько	NP_surn:m:sNGDAIL
Грынько	Грынько	NP_surn:f:sNGDAIL
Гуцько	Гуцько	NP_surn:m:sNGDAIL
Гуцько	Гуцько	NP_surn:f:sNGDAIL
Занько	Занько	NP_surn:m:sNGDAIL
Занько	Занько	NP_surn:f:sNGDAIL
Крачко	Крачко	NP_surn:m:sNGDAIL
Крачко	Крачко	NP_surn:f:sNGDAIL
Папандрэу	Папандрэу	NP_surn:m:sNGDAIL
Папандрэу	Папандрэу	NP_surn:f:sNGDAIL
Пікасо	Пікасо	NP_surn:m:sNGDAIL
Пікасо	Пікасо	NP_surn:f:sNGDAIL
Рабко	Рабко	NP_surn:m:sNGDAIL
Рабко	Рабко	NP_surn:f:sNGDAIL
Рацье	Рацье	NP_surn:m:sNGDAIL
Рацье	Рацье	NP_surn:f:sNGDAIL
Свароўскі	Свароўскі	NP_surn:m:sNGDAIL
Свароўскі	Свароўскі	NP_surn:f:sNGDAIL
Сіўко	Сіўко	NP_surn:m:sNGDAIL
Сіўко	Сіўко	NP_surn:f:sNGDAIL
Скурко	Скурко	NP_surn:m:sNGDAIL
Скурко	Скурко	NP_surn:f:sNGDAIL
Фарыно	Фарыно	NP_surn:m:sNGDAIL
Фарыно	Фарыно	NP_surn:f:sNGDAIL
Шапіра	Шапіра	NP_surn:m:sNGDAIL
Шапіра	Шапіра	NP_surn:f:sNGDAIL


Алі	Алі	NP_fn:m:sNGDAIL
Андрэ	Андрэ	NP_fn:m:sNGDAIL
Анры	Анры	NP_fn:m:sNGDAIL
Антоніа	Антоніа	NP_fn:m:sNGDAIL
Арні	Арні	NP_fn:m:sNGDAIL
Бруна	Бруна	NP_fn:m:sNGDAIL
Джуліа	Джуліа	NP_fn:m:sNGDAIL
Клаўдзіа	Клаўдзіа	NP_fn:m:sNGDAIL
Ларэнца	Ларэнца	NP_fn:m:sNGDAIL
Леа	Леа	NP_fn:m:sNGDAIL
Сільвіа	Сільвіа	NP_fn:m:sNGDAIL
Сільвіо	Сільвіо	NP_fn:m:sNGDAIL
Сярго	Сярго	NP_fn:m:sNGDAIL
Фабіа	Фабіа	NP_fn:m:sNGDAIL
Хасэ	Хасэ	NP_fn:m:sNGDAIL
Цімаці	Цімаці	NP_fn:m:sNGDAIL
Эндру	Эндру	NP_fn:m:sNGDAIL
Эўджэніа	Эўджэніа	NP_fn:m:sNGDAIL

Астрыд	Астрыд	NP_fn:f:sNGDAIL
Бірутэ	Бірутэ	NP_fn:f:sNGDAIL
Бэці	Бэці	NP_fn:f:sNGDAIL
Гюнеш	Гюнеш	NP_fn:f:sNGDAIL
Жаклін	Жаклін	NP_fn:f:sNGDAIL
Катрын	Катрын	NP_fn:f:sNGDAIL
Мерыям	Мерыям	NP_fn:f:sNGDAIL
Мірыям	Мірыям	NP_fn:f:sNGDAIL
Одры	Одры	NP_fn:f:sNGDAIL
Пэпі	Пэпі	NP_fn:f:sNGDAIL
Сафі	Сафі	NP_fn:f:sNGDAIL
Ціфані	Ціфані	NP_fn:f:sNGDAIL
Элон	Элон	NP_fn:f:sNGDAIL
Эстэль	Эстэль	NP_fn:f:sNGDAIL
Эстэр	Эстэр	NP_fn:f:sNGDAIL

Эдзі	Эдзі	NP_fn:m:sNGDAIL
Эдзі	Эдзі	NP_fn:f:sNGDAIL

Дунін-Марцінкевіч	Дунін-Марцінкевіч	NP_surn:m:sN
Дуніна-Марцінкевіча	Дунін-Марцінкевіч	NP_surn:m:sGA
Дуніну-Марцінкевічу	Дунін-Марцінкевіч	NP_surn:m:sD
Дунінам-Марцінкевічам	Дунін-Марцінкевіч	NP_surn:m:sI
Дуніне-Марцінкевічы	Дунін-Марцінкевіч	NP_surn:m:sL
Дунін-Марцінкевіча	Дунін-Марцінкевіч	NP_surn:m:sGA
Дунін-Марцінкевічу	Дунін-Марцінкевіч	NP_surn:m:sD
Дунін-Марцінкевічам	Дунін-Марцінкевіч	NP_surn:m:sI
Дунін-Марцінкевічы	Дунін-Марцінкевіч	NP_surn:m:sL