ЮНЕСКА	ЮНЕСКА	NP_abbr
ЮНЭСКА	ЮНЭСКА	NP_abbr
ЮНІСЕФ	ЮНІСЕФ	NP_abbr
ААН	ААН	NP_abbr
ЕС	ЕС	NP_abbr
СНД	СНД	NP_abbr
ССР	ССР	NP_abbr
НАН	НАН	NP_abbr
АН	АН	NP_abbr
БДУ	БДУ	NP_abbr
БДМУ	БДМУ	NP_abbr
БДПУ	БДПУ	NP_abbr
БДУІР	БДУІР	NP_abbr
БДЭУ	БДЭУ	NP_abbr
БНТУ	БНТУ	NP_abbr
ГрДУ	ГрДУ	NP_abbr
Белавія	Белавія	NP_abbr
ГР	ГР	NP_abbr
СБ	СБ	NP_abbr
ЛІМ	ЛІМ	NP_abbr
ЧАЭС	ЧАЭС	NP_abbr
БЕЛТА	БЕЛТА	NP_abbr
БелТА	БелТА	NP_abbr
БАТЭ	БАТЭ	NP_abbr
АБСЕ	АБСЕ	NP_abbr
МВФ	МВФ	NP_abbr
НАТА	НАТА	NP_abbr
АДКБ	АДКБ	NP_abbr
ЕўрАзЭС	ЕўрАзЭС	NP_abbr
БРСМ	БРСМ	NP_abbr
КХЛ	КХЛ	NP_abbr
УЕФА	УЕФА	NP_abbr
МТЗ	МТЗ	NP_abbr
МТС	МТС	NP_abbr
БМЗ	БМЗ	NP_abbr
ФПБ	ФПБ	NP_abbr
КП(б)Б	КП(б)Б	NP_abbr
АНТ	АНТ	NP_abbr
БМВ	БМВ	NP_abbr
БНФ	БНФ	NP_abbr
НББ	НББ	NP_abbr
ВТА	ВТА	NP_abbr
ПВТ	ПВТ	NP_abbr
АБФФ	АБФФ	NP_abbr
ММВЗ	ММВЗ	NP_abbr