тыс	тысяча	NumCard:Abbr
млн	мільён	NumCard:Abbr
млрд	мільярд	NumCard:Abbr
трлн	трыльён	NumCard:Abbr
інш	іншы	Pron:det:0
г	год	N:Abbr
г	грам	N:Abbr
г	горад	N:Abbr
гг	год	N:Abbr
ст	стагоддзе	N:Abbr
мм	міліметр	N:Abbr
см	сантыметр	N:Abbr
км	кіламетр	N:Abbr
кг	кілаграм	N:Abbr
мл	мілілітр	N:Abbr
Вт	ват	N:Abbr
кВт	кілават	N:Abbr
МВт	мегават	N:Abbr
ГВт	гігават	N:Abbr
вул	вуліца	N:Abbr
кв	кватэра	N:Abbr
тэл	тэлефон	N:Abbr
райпа	райпа	N:Abbr
вну	вну	N:Abbr
ц/га	ц/га	N:Abbr
м/с	м/с	N:Abbr
км/г	км/г	N:Abbr
км/гадз	км/гадз	N:Abbr
мг/дл	мг/дл	N:Abbr
ммоль/л	ммоль/л	N:Abbr
Гбіт/с	Гбіт/с	N:Abbr
руб/кг	руб/кг	N:Abbr
м/сек	м/сек	N:Abbr
АЭС	АЭС	N:Abbr
ДТЗ	ДТЗ	N:Abbr
РАУС	РАУС	N:Abbr
РУУС	РУУС	N:Abbr
УУС	УУС	N:Abbr
ГУУС	ГУУС	N:Abbr
СМІ	СМІ	N:Abbr
інтэрнэт-СМІ	інтэрнэт-СМІ	N:Abbr
СШ	СШ	N:Abbr
РУП	РУП	N:Abbr
УП	УП	N:Abbr
КДБ	КДБ	N:Abbr
КДК	КДК	N:Abbr
МНС	МНС	N:Abbr
ААТ	ААТ	N:Abbr
ЗАТ	ЗАТ	N:Abbr
ЦВК	ЦВК	N:Abbr
МТС	МТС	N:Abbr
ДПС	ДПС	N:Abbr
ЛПП	ЛПП	N:Abbr
ЖБК	ЖБК	N:Abbr
ЦЭЦ	ЦЭЦ	N:Abbr
ПТВ	ПТВ	N:Abbr
ЦК	ЦК	N:Abbr
СВК	СВК	N:Abbr
ЖКГ	ЖКГ	N:Abbr
ЦТ	ЦТ	N:Abbr
ПВХ	ПВХ	N:Abbr
РВК	РВК	N:Abbr
ЭВМ	ЭВМ	N:Abbr
ВМС	ВМС	N:Abbr
ВМФ	ВМФ	N:Abbr