а	а	Prep
аб	аб	Prep
аба	аба	Prep
ад	ад	Prep
апроч	апроч	Prep
без	без	Prep
ва	ва	Prep
да	да	Prep
дл€	дл€	Prep
дзел€	дзел€	Prep
з	з	Prep
за	за	Prep
з-за	з-за	Prep
з-над	з-над	Prep
з-пад	з-пад	Prep
з-па-над	з-па-над	Prep
з-па-за	з-па-за	Prep
к	к	Prep
ка	ка	Prep
кал€	кал€	Prep
кшталту	кшталту	Prep
л€	л€	Prep
м≥ж	м≥ж	Prep
на	на	Prep
над	над	Prep
нада	нада	Prep
па	па	Prep
пад	пад	Prep
пада	пада	Prep
па-над	па-над	Prep
па-за	па-за	Prep
пам≥ж	пам≥ж	Prep
перад	перад	Prep
перада	перада	Prep
прад	прад	Prep
прада	прада	Prep
пра	пра	Prep
праз	праз	Prep
пры	пры	Prep
са	са	Prep
у	у	Prep
ува	ува	Prep
цераз	цераз	Prep
паҐз	паҐз	Prep
акрам€	акрам€	Prep
апрача	апрача	Prep
бл≥з	бл≥з	Prep
замест	замест	Prep
звыш	звыш	Prep
наконт	наконт	Prep
накшталт	накшталт	Prep
паводле	паводле	Prep
с€род	с€род	Prep
абапал	абапал	Prep
бл≥зка	бл≥зка	Prep
вакол	вакол	Prep
воддаль	воддаль	Prep
збоку	збоку	Prep
зверху	зверху	Prep
ззаду	ззаду	Prep
злева	злева	Prep
м≥ма	м≥ма	Prep
наабапал	наабапал	Prep
наверсе	наверсе	Prep
наверх	наверх	Prep
наводдаль	наводдаль	Prep
навокал	навокал	Prep
наперад	наперад	Prep
наперадзе	наперадзе	Prep
насустрач	насустрач	Prep
насупраць	насупраць	Prep
непадалЄку	непадалЄку	Prep
паабапал	паабапал	Prep
паперад	паперад	Prep
паперадзе	паперадзе	Prep
пасл€	пасл€	Prep
пас€род	пас€род	Prep
пас€рэдз≥не	пас€рэдз≥не	Prep
паҐзверх	паҐзверх	Prep
побач	побач	Prep
побл≥з	побл≥з	Prep
поплеч	поплеч	Prep
поруч	поруч	Prep
скраю	скраю	Prep
скрозь	скрозь	Prep
спадыспаду	спадыспаду	Prep
спераду	спераду	Prep
супраць	супраць	Prep
узамен	узамен	Prep
уздоҐж	уздоҐж	Prep
уперад	уперад	Prep
уперадзе	уперадзе	Prep
упоперак	упоперак	Prep
услед	услед	Prep
усц€ж	усц€ж	Prep
адносна	адносна	Prep
адпаведна	адпаведна	Prep
згодна	згодна	Prep
паралельна	паралельна	Prep
прапарцы€нальна	прапарцы€нальна	Prep
раҐналежна	раҐналежна	Prep
выключаючы	выключаючы	Prep
дз€куючы	дз€куючы	Prep
канчаючы	канчаючы	Prep
уключаючы	уключаючы	Prep
разам	разам	Prep
сумесна	сумесна	Prep
н€гледз€чы	н€гледз€чы	Prep
падчас	падчас	Prep