абы	абы	Pcle
ага	ага	Pcle
аж	аж	Pcle
ажно	ажно	Pcle
акурат	акурат	Pcle
амаль	амаль	Pcle
ан≥	ан≥	Pcle
б	б	Pcle
бадай	бадай	Pcle
бо	бо	Pcle
бы	бы	Pcle
во	во	Pcle
вось	вось	Pcle
вунь	вунь	Pcle
выключна	выключна	Pcle
гэта	гэта	Pcle
дык	дык	Pcle
ж	ж	Pcle
жа	жа	Pcle
≥менна	≥менна	Pcle
маҐл€Ґ	маҐл€Ґ	Pcle
моҐ	моҐ	Pcle
нават	нават	Pcle
наҐрад	наҐрад	Pcle
не	не	Pcle
н≥	н≥	Pcle
н≥бы	н≥бы	Pcle
н≥быта	н≥быта	Pcle
ну	ну	Pcle
н€Ґжо	н€Ґжо	Pcle
н€хай	н€хай	Pcle
ось	ось	Pcle
от	от	Pcle
проста	проста	Pcle
прыбл≥зна	прыбл≥зна	Pcle
сапраҐды	сапраҐды	Pcle
так	так	Pcle
тольк≥	тольк≥	Pcle
ужо	ужо	Pcle
унь	унь	Pcle
усЄ-тк≥	усЄ-тк≥	Pcle
усЄ-так≥	усЄ-так≥	Pcle
ус€го	ус€го	Pcle
хай	хай	Pcle
хац€	хац€	Pcle
х≥ба	х≥ба	Pcle
хоць	хоць	Pcle
ц≥	ц≥	Pcle
€краз	€краз	Pcle
€шчэ	€шчэ	Pcle
-так≥	-так≥	Postfix
-тк≥	-тк≥	Postfix