а	а	Conj:coord
або	або	Conj:coord
аднак	аднак	Conj:coord
але	але	Conj:coord
альбо	альбо	Conj:coord
ды	ды	Conj:coord
дый	дый	Conj:coord
ж	ж	Conj:coord
жа	жа	Conj:coord
і	і	Conj:coord
таксама	таксама	Conj:coord
ні	ні	Conj:coord
то	то	Conj:coord
ці	ці	Conj:coord
затое	затое	Conj:coord
прычым	прычым	Conj:coord
прытым	прытым	Conj:coord
абы	абы	Conj:sub
бо	бо	Conj:sub
быццам	быццам	Conj:sub
дзе	дзе	Conj:sub
дык	дык	Conj:sub
каб	каб	Conj:sub
калі	калі	Conj:sub
ледзь	ледзь	Conj:sub
ледзьве	ледзьве	Conj:sub
нібы	нібы	Conj:sub
нібыта	нібыта	Conj:sub
няхай	няхай	Conj:sub
паколькі	паколькі	Conj:sub
пакуль	пакуль	Conj:sub
покі	покі	Conj:sub
таму	таму	Conj:sub
хай	хай	Conj:sub
хоць	хоць	Conj:sub
чым	чым	Conj:sub
што	што	Conj:sub
як	як	Conj:sub
балазе	балазе	Conj:sub