аг≥дней	аг≥дны	Adj:Comp
адважней	адважны	Adj:Comp
арыг≥нальней	арыг≥нальны	Adj:Comp
багацей	багаты	Adj:Comp
беспрасветней	беспрасветны	Adj:Comp
блажэнней	блажэнны	Adj:Comp
б€дней	бедны	Adj:Comp
б€лей	белы	Adj:Comp
важней	важны	Adj:Comp
вальней	вольны	Adj:Comp
вел≥зарней	вел≥зарны	Adj:Comp
вес€лей	в€сЄлы	Adj:Comp
выб≥тней	выб≥тны	Adj:Comp
выдатней	выдатны	Adj:Comp
грубей	грубы	Adj:Comp
гусцей	густы	Adj:Comp
гучней	гучны	Adj:Comp
драбней	дробны	Adj:Comp
дурней	дурны	Adj:Comp
жвавей	жвавы	Adj:Comp
жывап≥сней	жывап≥сны	Adj:Comp
заможней	заможны	Adj:Comp
зграбней	зграбны	Adj:Comp
зел€ней	з€лЄны	Adj:Comp
зручней	зручны	Adj:Comp
≥мкл≥вей	≥мкл≥вы	Adj:Comp
круцей	круты	Adj:Comp
культурней	культурны	Adj:Comp
магутней	магутны	Adj:Comp
м≥лей	м≥лы	Adj:Comp
надзейней	надзейны	Adj:Comp
неб€спечней	неб€спечны	Adj:Comp
непрыкметней	непрыкметны	Adj:Comp
падраб€зней	падраб€зны	Adj:Comp
паҐней	поҐны	Adj:Comp
пачварней	пачварны	Adj:Comp
прасторней	прасторны	Adj:Comp
прасцей	просты	Adj:Comp
прывабней	прывабны	Adj:Comp
прыстойней	прыстойны	Adj:Comp
пухлей	пухлы	Adj:Comp
раҐней	роҐны	Adj:Comp
свабодней	свабодны	Adj:Comp
св€тлей	светлы	Adj:Comp
складаней	складаны	Adj:Comp
слабей	слабы	Adj:Comp
слаҐней	слаҐны	Adj:Comp
смачней	смачны	Adj:Comp
см€лей	смелы	Adj:Comp
спакайней	спакойны	Adj:Comp
спраҐней	спраҐны	Adj:Comp
спрытней	спрытны	Adj:Comp
сп€лей	спелы	Adj:Comp
сталей	сталы	Adj:Comp
страйней	стройны	Adj:Comp
страшней	страшны	Adj:Comp
сумней	сумны	Adj:Comp
сур'Єзней	сур'Єзны	Adj:Comp
таленав≥цей	таленав≥ты	Adj:Comp
таҐсцей	тоҐсты	Adj:Comp
тупей	тупы	Adj:Comp
халадней	халодны	Adj:Comp
цверазей	цв€розы	Adj:Comp
цв€рдзей	цвЄрды	Adj:Comp
ц≥кавей	ц≥кавы	Adj:Comp
ц€мней	цЄмны	Adj:Comp
часцей	часты	Adj:Comp
чысцей	чысты	Adj:Comp
шчасл≥вей	шчасл≥вы	Adj:Comp
шчыльней	шчыльны	Adj:Comp
эфектыҐней	эфектыҐны	Adj:Comp
€сней	€сны	Adj:Comp

вузей	вузк≥	Adj:Comp
глыбей	глыбок≥	Adj:Comp
даҐней	даҐн≥	Adj:Comp
карацей	каротк≥	Adj:Comp
пазней	позн≥	Adj:Comp
радзей	рэдк≥	Adj:Comp
саладзей	салодк≥	Adj:Comp
таней	тонк≥	Adj:Comp

с≥ней	с≥н≥	Adj:Comp
галоҐней	галоҐны	Adj:Comp
радней	родны	Adj:Comp