я	Pron:pers:1	я мяне мне мной мною	sN sGA sDL sI sI
ты	Pron:pers:2	ты цябе табе табой табою	sN sGA sDL sI sI
ён	Pron:pers:3	ён яго яму ім	msN msGA msD msIL
яна	Pron:pers:3	яна яе ёй ёю	fsN fsGA fsDIL fsI
яно	Pron:pers:3	яно яго яму ім	nsN nsGA nsD nsIL
мы	Pron:pers:1	мы нас нам намі	pN pGA pD pIL
вы	Pron:pers:2	вы вас вам вамі	pN pGA pD pIL
яны	Pron:pers:3	яны іх ім імі	pN pGA pD pIL
сябе	Pron:refl	сябе сабе сабой сабою	sGA sDL sI sI
мой	Pron:poss	мой майго майму маім мая маёй маю маёй маёю маё майго майму маім мае маіх маім маімі	msNA msGA msD msIL fsN fsGDIL fsA fsGDIL fsI nsNA nsGA nsD nsIL 0pNA 0pGAL 0pD 0pI
твой	Pron:poss	твой твайго твайму тваім твая тваёй тваю тваёй тваёю тваё твайго твайму тваім твае тваіх тваім тваімі	msNA msGA msD msIL fsN fsGDIL fsA fsGDIL fsI nsNA nsGA nsD nsIL 0pNA 0pGAL 0pD 0pI
ягоны	Pron:poss	ягоны ягонага ягонаму ягоным ягоная ягонай ягонае ягонай ягоную ягонай ягонаю ягонае ягонага ягонаму ягоным ягоныя ягоных ягоным ягонымі	msNA msGA msD msIL fsN fsGDIL fsG fsGDIL fsA fsGDIL fsI nsNA nsGA nsD nsIL 0pNA 0pGAL 0pD 0pI
ейны	Pron:poss	ейны ейнага ейнаму ейным ейная ейнай ейнае ейнай ейную ейнай ейнаю ейнае ейнага ейнаму ейным ейныя ейных ейным ейнымі	msNA msGA msD msIL fsN fsGDIL fsG fsGDIL fsA fsGDIL fsI nsNA nsGA nsD nsIL 0pNA 0pGAL 0pD 0pI
ёйны	Pron:poss	ёйны ёйнага ёйнаму ёйным ёйная ёйнай ёйнае ёйнай ёйную ёйнай ёйнаю ёйнае ёйнага ёйнаму ёйным ёйныя ёйных ёйным ёйнымі	msNA msGA msD msIL fsN fsGDIL fsG fsGDIL fsA fsGDIL fsI nsNA nsGA nsD nsIL 0pNA 0pGAL 0pD 0pI
наш	Pron:poss	наш нашага нашаму нашым наша нашая нашай нашае нашай нашу нашую нашай нашаю наша нашага нашаму нашым нашы нашыя нашых нашым нашымі	msNA msGA msD msIL fsN fsN fsGDIL fsG fsGDIL fsA fsA fsGDIL fsI nsNA nsGA nsD nsIL 0pNA 0pNA 0pGAL 0pD 0pI
ваш	Pron:poss	ваш вашага вашаму вашым ваша вашая вашай вашае вашай вашу вашую вашай вашаю ваша вашага вашаму вашым вашы вашыя вашых вашым вашымі	msNA msGA msD msIL fsN fsN fsGDIL fsG fsGDIL fsA fsA fsGDIL fsI nsNA nsGA nsD nsIL 0pNA 0pNA 0pGAL 0pD 0pI
іхні	Pron:poss	іхні іхняга іхняму іхнім іхняя іхняй іхняе іхняй іхнюю іхняй іхняю іхняе іхняга іхняму іхнім іхнія іхніх іхнім іхнімі	msNA msGA msD msIL fsN fsGDIL fsG fsGDIL fsA fsGDIL fsI nsNA nsGA nsD nsIL 0pNA 0pGAL 0pD 0pI
свой	Pron:poss	свой свайго свайму сваім свая сваёй сваю сваёй сваёю сваё свайго свайму сваім свае сваіх сваім сваімі	msNA msGA msD msIL fsN fsGDIL fsA fsGDIL fsI nsNA nsGA nsD nsIL 0pNA 0pGAL 0pD 0pI
яго	Pron:poss	яго	0
яе	Pron:poss	яе	0
іх	Pron:poss	іх	0
увесь	Pron:det	увесь усяго усяму усім уся усёй усяе усёй усю усёй усёю усё усяго усяму усім усе усіх усім усімі	msNA msGA msD msIL fsN fsGDIL fsG fsGDIL fsA fsGDIL fsI nsNA nsGA nsD nsIL 0pNA 0pGAL 0pD 0pI
усякі	Pron:det	усякі усякага усякаму усякім усякая усякай усякае усякай усякую усякай усякаю усякае усякага усякаму усякім усякія усякіх усякім усякімі	msNA msGA msD msIL fsN fsGDIL fsG fsGDIL fsA fsGDIL fsI nsNA nsGA nsD nsIL 0pNA 0pGAL 0pD 0pI
усялякі	Pron:det	усялякі усялякага усялякаму усялякім усялякая усялякай усялякае усялякай усялякую усялякай усялякаю усялякае усялякага усялякаму усялякім усялякія усялякіх усялякім усялякімі	msNA msGA msD msIL fsN fsGDIL fsG fsGDIL fsA fsGDIL fsI nsNA nsGA nsD nsIL 0pNA 0pGAL 0pD 0pI
кожны	Pron:det	кожны кожнага кожнаму кожным кожная кожнай кожнае кожнай кожную кожнай кожнаю кожнае кожнага кожнаму кожным кожныя кожных кожным кожнымі	msNA msGA msD msIL fsN fsGDIL fsG fsGDIL fsA fsGDIL fsI nsNA nsGA nsD nsIL 0pNA 0pGAL 0pD 0pI
інакшы	Pron:det	інакшы інакшага інакшаму інакшым інакшая інакшай інакшае інакшай інакшую інакшай інакшаю інакшае інакшага інакшаму інакшым інакшыя інакшых інакшым інакшымі	msNA msGA msD msIL fsN fsGDIL fsG fsGDIL fsA fsGDIL fsI nsNA nsGA nsD nsIL 0pNA 0pGAL 0pD 0pI
іншы	Pron:det	іншы іншага іншаму іншым іншая іншай іншае іншай іншую іншай іншаю іншае іншага іншаму іншым іншыя іншых іншым іншымі	msNA msGA msD msIL fsN fsGDIL fsG fsGDIL fsA fsGDIL fsI nsNA nsGA nsD nsIL 0pNA 0pGAL 0pD 0pI
сам	Pron:det	сам самога самому самім сама самой саму само самога самому самім самі саміх самім самімі	msNA msGA msD msIL fsN fsGDIL fsA nsNA nsGA nsD nsIL 0pNA 0pGAL 0pD 0pI
самы	Pron:det	самы самага самаму самым самая самай самае самай самую самай самаю самае самага самаму самым самыя самых самым самымі	msNA msGA msD msIL fsN fsGDIL fsG fsGDIL fsA fsGDIL fsI nsNA nsGA nsD nsIL 0pNA 0pGAL 0pD 0pI
гэты	Pron:dem	гэты гэтага гэтаму гэтым гэтая гэта гэтай гэтае гэтай гэтую гэту гэтай гэтаю гэтае гэта гэтага гэтаму гэтым гэтыя гэтых гэтым гэтымі	msNA msGA msD msIL fsN fsN fsGDIL fsG fsGDIL fsA fsA fsGDIL fsI nsNA nsNA nsGA nsD nsIL 0pNA 0pGAL 0pD 0pI
гэны	Pron:dem	гэны гэнага гэнаму гэным гэная гэнай гэнае гэнай гэную гэнай гэнаю гэнае гэнага гэнаму гэным гэныя гэных гэным гэнымі	msNA msGA msD msIL fsN fsGDIL fsG fsGDIL fsA fsGDIL fsI nsNA nsGA nsD nsIL 0pNA 0pGAL 0pD 0pI
той	Pron:dem	той таго таму тым тая той тую той тою тое таго таму тым тыя тых тым тымі	msNA msGA msD msIL fsN fsGDIL fsA fsGDIL fsI nsNA nsGA nsD nsIL 0pNA 0pGAL 0pD 0pI
такі	Pron:dem	такі такога такому такім такая такой такое такой такую такой такою такое такога такому такім такія такіх такім такімі	msNA msGA msD msIL fsN fsGDIL fsG fsGDIL fsA fsGDIL fsI nsNA nsGA nsD nsIL 0pNA 0pGAL 0pD 0pI
гэтакі	Pron:dem	гэтакі гэтакага гэтакаму гэтакім гэтакая гэтакай гэтакае гэтакай гэтакую гэтакай гэтакаю гэтакае гэтакага гэтакаму гэтакім гэтакія гэтакіх гэтакім гэтакімі	msNA msGA msD msIL fsN fsGDIL fsG fsGDIL fsA fsGDIL fsI nsNA nsGA nsD nsIL 0pNA 0pGAL 0pD 0pI
гэткі	Pron:dem	гэткі гэткага гэткаму гэткім гэткая гэткай гэткае гэткай гэткую гэткай гэткаю гэткае гэткага гэткаму гэткім гэткія гэткіх гэткім гэткімі	msNA msGA msD msIL fsN fsGDIL fsG fsGDIL fsA fsGDIL fsI nsNA nsGA nsD nsIL 0pNA 0pGAL 0pD 0pI
столькі	Pron:dem	столькі столькіх столькім столькімі	pNA pGAL pD pI
гэтулькі	Pron:dem	гэтулькі гэтулькіх гэтулькім гэтулькімі	pNA pGAL pD pI
хто	Pron:rel	хто каго кога каму кім	sN sGA sGA sD sIL
што	Pron:rel	што чаго чаму чым	sNA sG sD sIL
які	Pron:rel	які якога якому якім якая якой якое якой якую якой якою якое якога якому якім якія якіх якім якімі	msNA msGA msD msIL fsN fsGDIL fsG fsGDIL fsA fsGDIL fsI nsNA nsGA nsD nsIL 0pNA 0pGAL 0pD 0pI
чый	Pron:rel	чый чыйго чыйму чыім чыя чыёй чыю чыёй чыёю чыё чыйго чыйму чыім чые чыіх чыім чыімі	msNA msGA msD msIL fsN fsGDIL fsA fsGDIL fsI nsNA nsGA nsD nsIL 0pNA 0pGAL 0pD 0pI
каторы	Pron:rel	каторы каторага катораму каторым каторая каторай каторае каторай каторую каторай катораю каторае каторага катораму каторым каторыя каторых каторым каторымі	msNA msGA msD msIL fsN fsGDIL fsG fsGDIL fsA fsGDIL fsI nsNA nsGA nsD nsIL 0pNA 0pGAL 0pD 0pI
колькі	Pron:rel	колькі колькіх колькім колькімі	pNA pGAL pD pI
ніхто	Pron:neg	ніхто нікога нікому нікім	sN sGA sD sIL
нішто	Pron:neg	нішто нічога нічому нічым	sNA sG sD sIL
аніхто	Pron:neg	аніхто анікога анікому анікім	sN sGA sD sIL
анішто	Pron:neg	анішто анічога анічому анічым	sNA sG sD sIL
ніякі	Pron:neg	ніякі ніякага ніякаму ніякім ніякая ніякай ніякае ніякай ніякую ніякай ніякаю ніякае ніякага ніякаму ніякім ніякія ніякіх ніякім ніякімі	msNA msGA msD msIL fsN fsGDIL fsG fsGDIL fsA fsGDIL fsI nsNA nsGA nsD nsIL 0pNA 0pGAL 0pD 0pI
аніякі	Pron:neg	аніякі аніякага аніякаму аніякім аніякая аніякай аніякае аніякай аніякую аніякай аніякаю аніякае аніякага аніякаму аніякім аніякія аніякіх аніякім аніякімі	msNA msGA msD msIL fsN fsGDIL fsG fsGDIL fsA fsGDIL fsI nsNA nsGA nsD nsIL 0pNA 0pGAL 0pD 0pI
ніводны	Pron:neg	ніводны ніводнага ніводнаму ніводным ніводная ніводнай ніводнае ніводнай ніводную ніводнай ніводнаю ніводнае ніводнага ніводнаму ніводным ніводныя ніводных ніводным ніводнымі	msNA msGA msD msIL fsN fsGDIL fsG fsGDIL fsA fsGDIL fsI nsNA nsGA nsD nsIL 0pNA 0pGAL 0pD 0pI
нічый	Pron:neg	нічый нічыйго нічыйму нічыім нічыя нічыёй нічыю нічыёй нічыёю нічыё нічыйго нічыйму нічыім нічые нічыіх нічыім нічыімі	msNA msGA msD msIL fsN fsGDIL fsA fsGDIL fsI nsNA nsGA nsD nsIL 0pNA 0pGAL 0pD 0pI
абы-хто	Pron:ind	абы-хто абы-каго абы-каму абы-кім	sN sGA sD sIL
абы-што	Pron:ind	абы-што абы-чаго абы-чаму абы-чым	sNA sG sD sIL
абы-які	Pron:ind	абы-які абы-якога абы-якому абы-якім абы-якая абы-якой абы-якое абы-якой абы-якую абы-якой абы-якою абы-якое абы-якога абы-якому абы-якім абы-якія абы-якіх абы-якім абы-якімі	msNA msGA msD msIL fsN fsGDIL fsG fsGDIL fsA fsGDIL fsI nsNA nsGA nsD nsIL 0pNA 0pGAL 0pD 0pI
абы-чый	Pron:ind	абы-чый абы-чыйго абы-чыйму абы-чыім абы-чыя абы-чыёй абы-чыю абы-чыёй абы-чыёю абы-чыё абы-чыйго абы-чыйму абы-чыім абы-чые абы-чыіх абы-чыім абы-чыімі	msNA msGA msD msIL fsN fsGDIL fsA fsGDIL fsI nsNA nsGA nsD nsIL 0pNA 0pGAL 0pD 0pI
абы-каторы	Pron:ind	абы-каторы абы-каторага абы-катораму абы-каторым абы-каторая абы-каторай абы-каторае абы-каторай абы-каторую абы-каторай абы-катораю абы-каторае абы-каторага абы-катораму абы-каторым абы-каторыя абы-каторых абы-каторым абы-каторымі	msNA msGA msD msIL fsN fsGDIL fsG fsGDIL fsA fsGDIL fsI nsNA nsGA nsD nsIL 0pNA 0pGAL 0pD 0pI
абы-колькі	Pron:ind	абы-колькі абы-колькіх абы-колькім абы-колькімі	pNA pGAL pD pI
хто-небудзь	Pron:ind	хто-небудзь каго-небудзь каму-небудзь кім-небудзь	sN sGA sD sIL
што-небудзь	Pron:ind	што-небудзь чаго-небудзь чаму-небудзь чым-небудзь	sNA sG sD sIL
які-небудзь	Pron:ind	які-небудзь якога-небудзь якому-небудзь якім-небудзь якая-небудзь якой-небудзь якое-небудзь якой-небудзь якую-небудзь якой-небудзь якою-небудзь якое-небудзь якога-небудзь якому-небудзь якім-небудзь якія-небудзь якіх-небудзь якім-небудзь якімі-небудзь	msNA msGA msD msIL fsN fsGDIL fsG fsGDIL fsA fsGDIL fsI nsNA nsGA nsD nsIL 0pNA 0pGAL 0pD 0pI
чый-небудзь	Pron:ind	чый-небудзь чыйго-небудзь чыйму-небудзь чыім-небудзь чыя-небудзь чыёй-небудзь чыю-небудзь чыёй-небудзь чыёю-небудзь чыё-небудзь чыйго-небудзь чыйму-небудзь чыім-небудзь чые-небудзь чыіх-небудзь чыім-небудзь чыімі-небудзь	msNA msGA msD msIL fsN fsGDIL fsA fsGDIL fsI nsNA nsGA nsD nsIL 0pNA 0pGAL 0pD 0pI
каторы-небудзь	Pron:ind	каторы-небудзь каторага-небудзь катораму-небудзь каторым-небудзь каторая-небудзь каторай-небудзь каторае-небудзь каторай-небудзь каторую-небудзь каторай-небудзь катораю-небудзь каторае-небудзь каторага-небудзь катораму-небудзь каторым-небудзь каторыя-небудзь каторых-небудзь каторым-небудзь каторымі-небудзь	msNA msGA msD msIL fsN fsGDIL fsG fsGDIL fsA fsGDIL fsI nsNA nsGA nsD nsIL 0pNA 0pGAL 0pD 0pI
колькі-небудзь	Pron:ind	колькі-небудзь колькіх-небудзь колькім-небудзь колькімі-небудзь	pNA pGAL pD pI
хтосьці	Pron:ind	хтосьці кагосьці камусьці кімсьці	sN sGA sD sIL
штосьці	Pron:ind	штосьці чагосьці чамусьці чымсьці	sNA sG sD sIL
якісьці	Pron:ind	якісьці якогасьці якомусьці якімсьці якаясьці якойсьці якоесьці якойсьці якуюсьці якойсьці якоюсьці якоесьці якогасьці якомусьці якімсьці якіясьці якіхсьці якімсьці якімісьці	msNA msGA msD msIL fsN fsGDIL fsG fsGDIL fsA fsGDIL fsI nsNA nsGA nsD nsIL 0pNA 0pGAL 0pD 0pI
чыйсьці	Pron:ind	чыйсьці чыйгосьці чыймусьці чыімсьці чыясьці чыёйсьці чыюсьці чыёйсьці чыёюсьці чыёсьці чыйгосьці чыймусьці чыімсьці чыесьці чыіхсьці чыімсьці чыімісьці	msNA msGA msD msIL fsN fsGDIL fsA fsGDIL fsI nsNA nsGA nsD nsIL 0pNA 0pGAL 0pD 0pI
хтось	Pron:ind	хтось кагось камусь кімсь кімсі кімся	sN sGA sD sIL sIL sIL
штось	Pron:ind	штось чагось чамусь чымсь чымсі чымся	sNA sG sD sIL sIL sIL
якісь	Pron:ind	якісь якогась якомусь якімсь якаясь якойсь якоесь якойсь якуюсь якойсь якоюсь якоесь якогась якомусь якімсь якіясь якіхсь якімсь якімісь	msNA msGA msD msIL fsN fsGDIL fsG fsGDIL fsA fsGDIL fsI nsNA nsGA nsD nsIL 0pNA 0pGAL 0pD 0pI
чыйсь	Pron:ind	чыйсь чыйгось чыймусь чыімсь чыясь чыёйсь чыюсь чыёйсь чыёюсь чыёсь чыйгось чыймусь чыімсь чыесь чыіхсь чыімсь чыімісь	msNA msGA msD msIL fsN fsGDIL fsA fsGDIL fsI nsNA nsGA nsD nsIL 0pNA 0pGAL 0pD 0pI
нехта	Pron:ind	нехта некага некаму некім	sN sGA sD sIL
нешта	Pron:ind	нешта нечага нечаму нечым	sNA sG sD sIL
нейкі	Pron:ind	нейкі нейкага нейкаму нейкім нейкая нейкай нейкае нейкай нейкую нейкай нейкаю нейкае нейкага нейкаму нейкім нейкія нейкіх нейкім нейкімі	msNA msGA msD msIL fsN fsGDIL fsG fsGDIL fsA fsGDIL fsI nsNA nsGA nsD nsIL 0pNA 0pGAL 0pD 0pI
нейчы	Pron:ind	нейчы нейчага нейчаму нейчым нейчая нейчай нейчую нейчай нейчае нейчага нейчаму нейчым нейчыя нейчых нейчым нейчымі	msNA msGA msD msIL fsN fsGDIL fsA fsGDIL nsNA nsGA nsD nsIL 0pNA 0pGAL 0pD 0pI
некі	Pron:ind	некі некага некаму некім некая некай некае некай некую некай некаю некае некага некаму некім некія некіх некім некімі	msNA msGA msD msIL fsN fsGDIL fsG fsGDIL fsA fsGDIL fsI nsNA nsGA nsD nsIL 0pNA 0pGAL 0pD 0pI
нечы	Pron:ind	нечы нечага нечаму нечым нечая нечай нечую нечай нечае нечага нечаму нечым нечыя нечых нечым нечымі	msNA msGA msD msIL fsN fsGDIL fsA fsGDIL nsNA nsGA nsD nsIL 0pNA 0pGAL 0pD 0pI
некаторы	Pron:ind	некаторы некаторага некатораму некаторым некаторая некаторай некаторае некаторай некаторую некаторай некатораю некаторае некаторага некатораму некаторым некаторыя некаторых некаторым некаторымі	msNA msGA msD msIL fsN fsGDIL fsG fsGDIL fsA fsGDIL fsI nsNA nsGA nsD nsIL 0pNA 0pGAL 0pD 0pI
некалькі	Pron:ind	некалькі некалькіх некалькім некалькімі	pNA pGAL pD pI
хто-ніхто	Pron:ind	хто-ніхто каго-нікаго каму-нікаму кім-нікім	sN sGA sD sIL
што-нішто	Pron:ind	што-нішто чаго-нічага чаму-нічаму чым-нічым	sNA sG sD sIL
які-ніякі	Pron:ind	які-ніякі якога-ніякога якому-ніякому якім-ніякім якая-ніякая якой-ніякой якое-ніякое якой-ніякой якую-ніякую якой-ніякой якою-ніякою якое-ніякое якога-ніякога якому-ніякому якім-ніякім якія-ніякія якіх-ніякіх якім-ніякім якімі-ніякімі	msNA msGA msD msIL fsN fsGDIL fsG fsGDIL fsA fsGDIL fsI nsNA nsGA nsD nsIL 0pNA 0pGAL 0pD 0pI
чый-нічый	Pron:ind	чый-нічый чыйго-нічыйго чыйму-нічыйму чыім-нічыім чыя-нічыя чыёй-нічыёй чыю-нічыю чыёй-нічыёй чыёю-нічыёю чыё-нічыё чыйго-нічыйго чыйму-нічыйму чыім-нічыім чые-нічые чыіх-нічыіх чыім-нічыім чыімі-нічыімі	msNA msGA msD msIL fsN fsGDIL fsA fsGDIL fsI nsNA nsGA nsD nsIL 0pNA 0pGAL 0pD 0pI
хто-колечы	Pron:ind	хто-колечы каго-колечы каму-колечы кім-колечы	sN sGA sD sIL
што-колечы	Pron:ind	што-колечы чаго-колечы чаму-колечы чым-колечы	sNA sG sD sIL
які-колечы	Pron:ind	які-колечы якога-колечы якому-колечы якім-колечы якая-колечы якой-колечы якое-колечы якой-колечы якую-колечы якой-колечы якою-колечы якое-колечы якога-колечы якому-колечы якім-колечы якія-колечы якіх-колечы якім-колечы якімі-колечы	msNA msGA msD msIL fsN fsGDIL fsG fsGDIL fsA fsGDIL fsI nsNA nsGA nsD nsIL 0pNA 0pGAL 0pD 0pI
які-кольвек	Pron:ind	які-кольвек якога-кольвек якому-кольвек якім-кольвек якая-кольвек якой-кольвек якое-кольвек якой-кольвек якую-кольвек якой-кольвек якою-кольвек якое-кольвек якога-кольвек якому-кольвек якім-кольвек якія-кольвек якіх-кольвек якім-кольвек якімі-кольвек	msNA msGA msD msIL fsN fsGDIL fsG fsGDIL fsA fsGDIL fsI nsNA nsGA nsD nsIL 0pNA 0pGAL 0pD 0pI
чый-колечы	Pron:ind	чый-колечы чыйго-колечы чыйму-колечы чыім-колечы чыя-колечы чыёй-колечы чыю-колечы чыёй-колечы чыёю-колечы чыё-колечы чыйго-колечы чыйму-колечы чыім-колечы чые-колечы чыіх-колечы чыім-колечы чыімі-колечы	msNA msGA msD msIL fsN fsGDIL fsA fsGDIL fsI nsNA nsGA nsD nsIL 0pNA 0pGAL 0pD 0pI
сякі-такі	Pron:ind	сякі-такі сякога-такога сякому-такому сякім-такім сякая-такая сякой-такой сякое-такое сякой-такой сякую-такую сякой-такой сякою-такою сякое-такое сякога-такога сякому-такому сякім-такім сякія-такія сякіх-такіх сякім-такім сякімі-такімі	msNA msGA msD msIL fsN fsGDIL fsG fsGDIL fsA fsGDIL fsI nsNA nsGA nsD nsIL 0pNA 0pGAL 0pD 0pI
такі-сякі	Pron:ind	такі-сякі такога-сякога такому-сякому такім-сякім такая-сякая такой-сякой такое-сякое такой-сякой такую-сякую такой-сякой такою-сякою такое-сякое такога-сякога такому-сякому такім-сякім такія-сякія такіх-сякіх такім-сякім такімі-сякімі	msNA msGA msD msIL fsN fsGDIL fsG fsGDIL fsA fsGDIL fsI nsNA nsGA nsD nsIL 0pNA 0pGAL 0pD 0pI
сёй-той	Pron:ind	сёй-той сяго-таго сяму-таму сім-тым сёе-тое сяго-таго сяму-таму сім-тым	msNA msGA msD msIL nsNA nsGA nsD nsIL