горш	дрэнны	Adj:Comp	1
даражэйш	дарагі	Adj:Comp	1
маладзейш	малады	Adj:Comp	1
малодш	малады	Adj:Comp	1
мацнейш	моцны	Adj:Comp	1
менш	малы	Adj:Comp	1
ніжэйш	нізкі	Adj:Comp	1
старэйш	стары	Adj:Comp	1
таннейш	танны	Adj:Comp	1
буйнейш	буйны	Adj:Comp	1

агіднейш	агідны	Adj:Comp	1
адважнейш	адважны	Adj:Comp	1
арыгінальнейш	арыгінальны	Adj:Comp	1
багацейш	багаты	Adj:Comp	1
беспрасветнейш	беспрасветны	Adj:Comp	1
блажэннейш	блажэнны	Adj:Comp	1
бяднейш	бедны	Adj:Comp	1
бялейш	белы	Adj:Comp	1
важнейш	важны	Adj:Comp	1
вальнейш	вольны	Adj:Comp	1
велізарнейш	велізарны	Adj:Comp	1
весялейш	вясёлы	Adj:Comp	1
выбітнейш	выбітны	Adj:Comp	1
выдатнейш	выдатны	Adj:Comp	1
галоўнейш	галоўны	Adj:Comp	1
грубейш	грубы	Adj:Comp	1
гусцейш	густы	Adj:Comp	1
гучнейш	гучны	Adj:Comp	1
драбнейш	дробны	Adj:Comp	1
дурнейш	дурны	Adj:Comp	1
жвавейш	жвавы	Adj:Comp	1
жывапіснейш	жывапісны	Adj:Comp	1
заможнейш	заможны	Adj:Comp	1
зграбнейш	зграбны	Adj:Comp	1
зелянейш	зялёны	Adj:Comp	1
зручнейш	зручны	Adj:Comp	1
імклівейш	імклівы	Adj:Comp	1
круцейш	круты	Adj:Comp	1
культурнейш	культурны	Adj:Comp	1
магутнейш	магутны	Adj:Comp	1
мілейш	мілы	Adj:Comp	1
надзейнейш	надзейны	Adj:Comp	1
небяспечнейш	небяспечны	Adj:Comp	1
непрыкметнейш	непрыкметны	Adj:Comp	1
падрабязнейш	падрабязны	Adj:Comp	1
паўнейш	поўны	Adj:Comp	1
пачварнейш	пачварны	Adj:Comp	1
прасторнейш	прасторны	Adj:Comp	1
прасцейш	просты	Adj:Comp	1
прывабнейш	прывабны	Adj:Comp	1
прыстойнейш	прыстойны	Adj:Comp	1
пухлейш	пухлы	Adj:Comp	1
раднейш	родны	Adj:Comp	1
раўнейш	роўны	Adj:Comp	1
свабоднейш	свабодны	Adj:Comp	1
святлейш	светлы	Adj:Comp	1
складанейш	складаны	Adj:Comp	1
слабейш	слабы	Adj:Comp	1
слаўнейш	слаўны	Adj:Comp	1
смачнейш	смачны	Adj:Comp	1
смялейш	смелы	Adj:Comp	1
спакайнейш	спакойны	Adj:Comp	1
спраўнейш	спраўны	Adj:Comp	1
спрытнейш	спрытны	Adj:Comp	1
спялейш	спелы	Adj:Comp	1
сталейш	сталы	Adj:Comp	1
страйнейш	стройны	Adj:Comp	1
страшнейш	страшны	Adj:Comp	1
сумнейш	сумны	Adj:Comp	1
сур'ёзнейш	сур'ёзны	Adj:Comp	1
таленавіцейш	таленавіты	Adj:Comp	1
таўсцейш	тоўсты	Adj:Comp	1
тупейш	тупы	Adj:Comp	1
халаднейш	хадодны	Adj:Comp	1
цверазейш	цвярозы	Adj:Comp	1
цвярдзейш	цвёрды	Adj:Comp	1
цікавейш	цікавы	Adj:Comp	1
цямнейш	цёмны	Adj:Comp	1
часцейш	часты	Adj:Comp	1
чысцейш	чысты	Adj:Comp	1
шчаслівейш	шчаслівы	Adj:Comp	1
шчыльнейш	шчыльны	Adj:Comp	1
эфектыўнейш	эфектыўны	Adj:Comp	1
яснейш	ясны	Adj:Comp	1

вузейш	вузкі	Adj:Comp	1
глыбейш	глыбокі	Adj:Comp	1
даўнейш	даўні	Adj:Comp	1
карацейш	кароткі	Adj:Comp	1
пазнейш	позні	Adj:Comp	1
радзейш	рэдкі	Adj:Comp	1
саладзейш	салодкі	Adj:Comp	1
сінейш	сіні	Adj:Comp	1
танейш	тонкі	Adj:Comp	1

найаўтарытэтнейш	аўтарытэтны	Adj:Sup	1
найбяднейш	бедны	Adj:Sup	1
найвыдатнейш	выдатны	Adj:Sup	1
найвыключнейш	выключны	Adj:Sup	1
найгалоўнейш	галоўны	Adj:Sup	1
найганебнейш	ганебны	Adj:Sup	1
найгоднейш	годны	Adj:Sup	1
найгусцейш	густы	Adj:Sup	1
найдалікатнейш	далікатны	Adj:Sup	1
найдасканалейш	дасканалы	Adj:Sup	1
найдзіўнейш	дзіўны	Adj:Sup	1
найзелянейш	зялёны	Adj:Sup	1
найлюбімейш	любімы	Adj:Sup	1
наймагутнейш	магутны	Adj:Sup	1
наймаладзейш	малады	Adj:Sup	1
наймацнейш	моцны	Adj:Sup	1
наймаштабнейш	маштабны	Adj:Sup	1
найнікчэмнейш	нікчэмны	Adj:Sup	1
найпадлейш	подлы	Adj:Sup	1
найпадобнейш	падобны	Adj:Sup	1
найпатрэбнейш	патрэбны	Adj:Sup	1
найпышнейш	пышны	Adj:Sup	1
найсакавіцейш	сакавіты	Adj:Sup	1
найскладанейш	складаны	Adj:Sup	1
найскладнейш	складны	Adj:Sup	1
найслаўнейш	слаўны	Adj:Sup	1
найсмачнейш	смачны	Adj:Sup	1
найсмялейш	смелы	Adj:Sup	1
найсправядлівейш	справядлівы	Adj:Sup	1
найталенавіцейш	таленавіты	Adj:Sup	1
найцудоўнейш	цудоўны	Adj:Sup	1
найчарнейш	чорны	Adj:Sup	1
найчысцейш	чысты	Adj:Sup	1
найшчаслівейш	шчаслівы	Adj:Sup	1