ага	ага	Intj
ай	ай	Intj
алё	алё	Intj
ало	ало	Intj
ат	ат	Intj
ах	ах	Intj
біс	біс	Intj
брава	брава	Intj
га	га	Intj
гэй	гэй	Intj
ну-ну	ну-ну	Intj
ну-у	ну-у	Intj
ого	ого	Intj
о-го	о-го	Intj
ого-го	ого-го	Intj
ой	ой	Intj
ох	ох	Intj
тфу	тфу	Intj
уга	уга	Intj
угу	угу	Intj
ура	ура	Intj
ух	ух	Intj
ха	ха	Intj
ха-ха	ха-ха	Intj
ха-ха-ха	ха-ха-ха	Intj
хм	хм	Intj
цьфу	цьфу	Intj
эге	эге	Intj
э-ге	э-ге	Intj
эге-ге	эге-ге	Intj
эй	эй	Intj
эх	эх	Intj
э-э	э-э	Intj
ку-ку	ку-ку	Intj
ква-ква	ква-ква	Intj
божа	божа	Intj
божачка	божачка	Intj
божачкі	божачкі	Intj
божухна	божухна	Intj
госпадзі	госпадзі	Intj
госпадзе	госпадзе	Intj
далібог	далібог	Intj
дальбог	дальбог	Intj
дабранач	дабранач	Intj
прывітанне	прывітанне	Intj
вітаем	вітаць	Intj
вітаю	вітаць	Intj
выбачай	выбачаць	Intj
выбачайце	выбачаць	Intj
даруй	дараваць	Intj
даруйце	дараваць	Intj
дзякуем	дзякаваць	Intj
дзякуй	дзякаваць	Intj
дзякую	дзякаваць	Intj
прабач	прабачыць	Intj
прабачце	прабачыць	Intj
# калі ласка	калі ласка	Intj
# да пабачэння	да пабачэння	Intj
# да сустрэчы	да сустрэчы	Intj
# добры дзень	добры дзень	Intj
# добрай раніцы	добрай раніцы	Intj
# добры вечар	добры вечар	Intj