нуль	NumCard	нуль нуля нулю нулём нулі нулі нулёў нулям нулямі нулях	m:sNA m:sG m:sD m:sI m:sL m:pNA m:pG m:pD m:pI m:pL
адзін	NumCard	адзін аднаго аднаму адным адна адной аднае адну адною адно аднаго аднаму адным адны адных адным аднымі	msNA msGA msD msIL fsN fsGDIL fsG fsA fsI nsNA nsG nsD nsIL 0pNA 0pGAL 0pD 0pI
паўтара	NumCard	паўтара паўтара паўтары	m0NGDAIL n0NGDAIL f0NGDAIL
два	NumCard	два дзве два двух дзвюх двух двум дзвюм двум двума дзвюма двума	m0NA f0NA n0NA m0GAL f0GAL n0GAL m0D f0D n0D m0I f0I n0I
тры	NumCard	тры трох тром трыма	00NA 00GAL 00D 00I
чатыры	NumCard	чатыры чатырох чатыром чатырма	00NA 00GAL 00D 00I
пяць	NumCard	пяць пяці пяццю	00NA 00GDL 00I
шэсць	NumCard	шэсць шасці шасцю	00NA 00GDL 00I
сем	NumCard	сем сямі сямю	00NA 00GDL 00I
восем	NumCard	восем васьмі васьмю	00NA 00GDL 00I
дзевяць	NumCard	дзевяць дзевяці дзевяццю	00NA 00GDL 00I
дзесяць	NumCard	дзесяць дзесяці дзесяццю	00NA 00GDL 00I
адзінаццаць	NumCard	адзінаццаць адзінаццаці адзінаццаццю	00NA 00GDL 00I
дванаццаць	NumCard	дванаццаць дванаццаці дванаццаццю	00NA 00GDL 00I
трынаццаць	NumCard	трынаццаць трынаццаці трынаццаццю	00NA 00GDL 00I
чатырнаццаць	NumCard	чатырнаццаць чатырнаццаці чатырнаццаццю	00NA 00GDL 00I
пятнаццаць	NumCard	пятнаццаць пятнаццаці пятнаццаццю	00NA 00GDL 00I
шаснаццаць	NumCard	шаснаццаць шаснаццаці шаснаццаццю	00NA 00GDL 00I
сямнаццаць	NumCard	сямнаццаць сямнаццаці сямнаццаццю	00NA 00GDL 00I
васямнаццаць	NumCard	васямнаццаць васямнаццаці васямнаццаццю	00NA 00GDL 00I
дзевятнаццаць	NumCard	дзевятнаццаць дзевятнаццаці дзевятнаццаццю	00NA 00GDL 00I
дваццаць	NumCard	дваццаць дваццаці дваццаццю	00NA 00GDL 00I
трыццаць	NumCard	трыццаць трыццаці трыццаццю	00NA 00GDL 00I
сорак	NumCard	сорак сарака	00NA 00GDIL
пяцьдзясят	NumCard	пяцьдзясят пяцідзесяці пяццюдзесяццю	00NA 00GDL 00I
шэсцьдзясят	NumCard	шэсцьдзясят шасцідзесяці шасцюдзесяццю	00NA 00GDL 00I
семдзесят	NumCard	семдзесят сямідзесяці сямюдзесяццю	00NA 00GDL 00I
восемдзесят	NumCard	восемдзесят васьмідзесяці васьмюдзесяццю	00NA 00GDL 00I
дзевяноста	NumCard	дзевяноста	00NGDAIL
сто	NumCard	сто ста	00NA 00GDIL
паўтараста	NumCard	паўтараста	00NGDAIL
дзвесце	NumCard	дзвесце двухсот двумстам двумастамі двухстах	00NA 00G 00D 00I 00L
трыста	NumCard	трыста трохсот тромстам трымастамі трохстах	00NA 00G 00D 00I 00L
чатырыста	NumCard	чатырыста чатырохсот чатыромстам чатырмастамі чатырохстах	00NA 00G 00D 00I 00L
пяцьсот	NumCard	пяцьсот пяцісот пяцістам пяццюстамі пяцістах	00NA 00G 00D 00I 00L
шэсцьсот	NumCard	шэсцьсот шасцісот шасцістам шасцюстамі шасцістах	00NA 00G 00D 00I 00L
семсот	NumCard	семсот сямісот сямістам сямюстамі сямістах	00NA 00G 00D 00I 00L
восемсот	NumCard	восемсот васьмісот васьмістам васьмюстамі васьмістах	00NA 00G 00D 00I 00L
дзевяцьсот	NumCard	дзевяцьсот дзевяцісот дзевяцістам дзевяцістамі дзевяцістах	00NA 00G 00D 00I 00L
тысяча	NumCard	тысяча тысячы тысячу тысячай тысячы тысяч тысячам тысячамі тысячах	f:sN f:sGDL f:sA f:sI f:pNA f:pG f:pD f:pI f:pL
мільён	NumCard	мільён мільёна мільёну мільёнам мільёне мільёны мільёнаў мільёнам мільёнамі мільёнах	m:sNA m:sG m:sD m:sI m:sL m:pNA m:pG m:pD m:pI m:pL
мільярд	NumCard	мільярд мільярда мільярду мільярдам мільярдзе мільярды мільярдаў мільярдам мільярдамі мільярдах	m:sNA m:sG m:sD m:sI m:sL m:pNA m:pG m:pD m:pI m:pL
більён	NumCard	більён більёна більёну більёнам більёне більёны більёнаў більёнам більёнамі більёнах	m:sNA m:sG m:sD m:sI m:sL m:pNA m:pG m:pD m:pI m:pL
трыльён	NumCard	трыльён трыльёна трыльёну трыльёнам трыльёне трыльёны трыльёнаў трыльёнам трыльёнамі трыльёнах	m:sNA m:sG m:sD m:sI m:sL m:pNA m:pG m:pD m:pI m:pL
квадрыльён	NumCard	квадрыльён квадрыльёна квадрыльёну квадрыльёнам квадрыльёне квадрыльёны квадрыльёнаў квадрыльёнам квадрыльёнамі квадрыльёнах	m:sNA m:sG m:sD m:sI m:sL m:pNA m:pG m:pD m:pI m:pL
квінтыльён	NumCard	квінтыльён квінтыльёна квінтыльёну квінтыльёнам квінтыльёне квінтыльёны квінтыльёнаў квінтыльёнам квінтыльёнамі квінтыльёнах	m:sNA m:sG m:sD m:sI m:sL m:pNA m:pG m:pD m:pI m:pL
вігінтыльён	NumCard	вігінтыльён вігінтыльёна вігінтыльёну вігінтыльёнам вігінтыльёне вігінтыльёны вігінтыльёнаў вігінтыльёнам вігінтыльёнамі вігінтыльёнах	m:sNA m:sG m:sD m:sI m:sL m:pNA m:pG m:pD m:pI m:pL

абедзве	NumColl	абедзве абедзвюх абедзвюм абедзвюма	fNA fGAL fD fI
абодва	NumColl	абодва абодвух абодвум абодвума	mNA mGAL mD mI
абое	NumColl	абое абаіх абаім абаімі	0NA 0GAL 0D 0I
двое	NumColl	двое дваіх дваім дваімі	0NA 0GAL 0D 0I
трое	NumColl	трое траіх траім траімі	0NA 0GAL 0D 0I
чацвёра	NumColl	чацвёра чацвярых чацвярым чацвярымі	0NA 0GAL 0D 0I
пяцёра	NumColl	пяцёра пяцярых пяцярым пяцярымі	0NA 0GAL 0D 0I
шасцёра	NumColl	шасцёра шасцярых шасцярым шасцярымі	0NA 0GAL 0D 0I
сямёра	NumColl	сямёра семярых семярым семярымі	0NA 0GAL 0D 0I
васьмёра	NumColl	васьмёра васьмярых васьмярым васьмярымі	0NA 0GAL 0D 0I
дзявяцера	NumColl	дзявяцера дзевяцярых дзевяцярым дзевяцярымі	0NA 0GAL 0D 0I
дзясяцера	NumColl	дзясяцера дзесяцярых дзесяцярым дзесяцярымі	0NA 0GAL 0D 0I
адзінаццацера	NumColl	адзінаццацера адзінаццацярых адзінаццацярым адзінаццацярымі	0NA 0GAL 0D 0I
дванаццацера	NumColl	дванаццацера дванаццацярых дванаццацярым дванаццацярымі	0NA 0GAL 0D 0I
