# Превосходная степень

найбліжэй	блізка	Adv:Sup
найважней	важна	Adv:Sup
найвастрэй	востра	Adv:Sup
найвышэй	высока	Adv:Sup
найглыбей	глыбока	Adv:Sup
найдалей	далёка	Adv:Sup
найлепш	добра	Adv:Sup
найдаражэй	дорага	Adv:Sup
найдаўжэй	доўга	Adv:Sup
найдрабней	дробна	Adv:Sup
найгорш	дрэнна	Adv:Sup
найзванчэй	звонка	Adv:Sup
найкарацей	каротка	Adv:Sup
найкарацей	коратка	Adv:Sup
найлягчэй	лёгка	Adv:Sup
найменей	мала	Adv:Sup
найменш	мала	Adv:Sup
наймілей	міла	Adv:Sup
найболей	многа	Adv:Sup
найбольш	многа	Adv:Sup
наймацней	моцна	Adv:Sup
наймудрэй	мудра	Adv:Sup
найпільней	пільна	Adv:Sup
найпрасцей	проста	Adv:Sup
найпрыгажэй	прыгожа	Adv:Sup
найраней	рана	Adv:Sup
найсвятлей	светла	Adv:Sup
найскарэй	скора	Adv:Sup
найхутчэй	хутка	Adv:Sup
найцікавей	цікава	Adv:Sup
найцішэй	ціха	Adv:Sup
найцяжэй	цяжка	Adv:Sup
найчасцей	часта	Adv:Sup
найчысцей	чыста	Adv:Sup
найшырэй	шырока	Adv:Sup

# Сравнительная степень

бліжэй	блізка	Adv:Comp
важней	важна	Adv:Comp
вастрэй	востра	Adv:Comp
вышэй	высока	Adv:Comp
глыбей	глыбока	Adv:Comp
далей	далёка	Adv:Comp
лепш	добра	Adv:Comp
даражэй	дорага	Adv:Comp
даўжэй	доўга	Adv:Comp
драбней	дробна	Adv:Comp
горш	дрэнна	Adv:Comp
званчэй	звонка	Adv:Comp
карацей	каротка	Adv:Comp
карацей	коратка	Adv:Comp
лягчэй	лёгка	Adv:Comp
меней	мала	Adv:Comp
менш	мала	Adv:Comp
мілей	міла	Adv:Comp
болей	многа	Adv:Comp
больш	многа	Adv:Comp
мацней	моцна	Adv:Comp
мудрэй	мудра	Adv:Comp
пільней	пільна	Adv:Comp
прасцей	проста	Adv:Comp
прыгажэй	прыгожа	Adv:Comp
раней	рана	Adv:Comp
святлей	светла	Adv:Comp
скарэй	скора	Adv:Comp
хутчэй	хутка	Adv:Comp
цікавей	цікава	Adv:Comp
цішэй	ціха	Adv:Comp
цяжэй	цяжка	Adv:Comp
часцей	часта	Adv:Comp
чысцей	чыста	Adv:Comp
шырэй	шырока	Adv:Comp
агідней	агідна	Adv:Comp
агрэсіўней	агрэсіўна	Adv:Comp
адважней	адважна	Adv:Comp
адказней	адказна	Adv:Comp
адэкватней	адэкватна	Adv:Comp
азартней	азартна	Adv:Comp
актыўней	актыўна	Adv:Comp
акуратней	акуратна	Adv:Comp
аператыўней	аператыўна	Adv:Comp
апетытней	апетытна	Adv:Comp
аптымальней	аптымальна	Adv:Comp
аптымістычней	аптымістычна	Adv:Comp
арганічней	арганічна	Adv:Comp
артыстычней	артыстычна	Adv:Comp
арыгінальней	арыгінальна	Adv:Comp
асцярожлівей	асцярожліва	Adv:Comp
асцярожней	асцярожна	Adv:Comp
ахвотней	ахвотна	Adv:Comp
ашчадней	ашчадна	Adv:Comp
багацей	багата	Adv:Comp
бядней	бедна	Adv:Comp
бялей	бела	Adv:Comp
беражлівей	беражліва	Adv:Comp
бескарысней	бескарысна	Adv:Comp
бесклапотней	бесклапотна	Adv:Comp
беспрасветней	беспрасветна	Adv:Comp
бесталковей	бесталкова	Adv:Comp
бесчалавечней	бесчалавечна	Adv:Comp
блажэнней	блажэнна	Adv:Comp
байчэй	бойка	Adv:Comp
барзджэй	борзда	Adv:Comp
боязней	боязна	Adv:Comp
брудней	брудна	Adv:Comp
буйней	буйна	Adv:Comp
велізарней	велізарна	Adv:Comp
велічней	велічна	Adv:Comp
весялей	весела	Adv:Comp
ветлівей	ветліва	Adv:Comp
відавочней	відавочна	Adv:Comp
відней	відно	Adv:Comp
вільготней	вільготна	Adv:Comp
віртуозней	віртуозна	Adv:Comp
вальней	вольна	Adv:Comp
вузей	вузка	Adv:Comp
вульгарней	вульгарна	Adv:Comp
выбітней	выбітна	Adv:Comp
выгадней	выгадна	Adv:Comp
выдатней	выдатна	Adv:Comp
выйгрышней	выйгрышна	Adv:Comp
выразней	выразна	Adv:Comp
гарманічней	гарманічна	Adv:Comp
гаротней	гаротна	Adv:Comp
гарэзлівей	гарэзліва	Adv:Comp
гарэзней	гарэзна	Adv:Comp
гасцінней	гасцінна	Adv:Comp
гладчэй	гладка	Adv:Comp
глушэй	глуха	Adv:Comp
галадней	голадна	Adv:Comp
галасней	голасна	Adv:Comp
гарачэй	горача	Adv:Comp
гарчэй	горка	Adv:Comp
грацыёзней	грацыёзна	Adv:Comp
грамчэй	громка	Adv:Comp
грубей	груба	Adv:Comp
грунтоўней	грунтоўна	Adv:Comp
гуманней	гуманна	Adv:Comp
гусцей	густа	Adv:Comp
гучней	гучна	Adv:Comp
дакладней	дакладна	Adv:Comp
далікатней	далікатна	Adv:Comp
даступней	даступна	Adv:Comp
дасціпней	дасціпна	Adv:Comp
даўней	даўно	Adv:Comp
дзешавей	дзешава	Adv:Comp
дружней	дружна	Adv:Comp
дужэй	дужа	Adv:Comp
дурней	дурна	Adv:Comp
духмяней	духмяна	Adv:Comp
душней	душна	Adv:Comp
ямчэй	ёмка	Adv:Comp
жаласлівей	жаласліва	Adv:Comp
жаласней	жаласна	Adv:Comp
жалобней	жалобна	Adv:Comp
жвавей	жвава	Adv:Comp
жудасней	жудасна	Adv:Comp
журботней	журботна	Adv:Comp
жывей	жыва	Adv:Comp
жывапісней	жывапісна	Adv:Comp
забаўней	забаўна	Adv:Comp
заможней	заможна	Adv:Comp
зграбней	зграбна	Adv:Comp
зеляней	зелена	Adv:Comp
зладжаней	зладжана	Adv:Comp
зручней	зручна	Adv:Comp
зырчэй	зырка	Adv:Comp
зычней	зычна	Adv:Comp
імклівей	імкліва	Adv:Comp
каларытней	каларытна	Adv:Comp
кампактней	кампактна	Adv:Comp
камфортней	камфортна	Adv:Comp
канкрэтней	канкрэтна	Adv:Comp
карысней	карысна	Adv:Comp
карэктней	карэктна	Adv:Comp
кіслей	кісла	Adv:Comp
круглей	кругла	Adv:Comp
круцей	крута	Adv:Comp
крывей	крыва	Adv:Comp
культурней	культурна	Adv:Comp
кур'ёзней	кур'ёзна	Adv:Comp
кучней	кучна	Adv:Comp
лагічней	лагічна	Adv:Comp
лагодней	лагодна	Adv:Comp
лаканічней	лаканічна	Adv:Comp
ласкавей	ласкава	Adv:Comp
лацвей	латва	Adv:Comp
лаяльней	лаяльна	Adv:Comp
лірычней	лірычна	Adv:Comp
магутней	магутна	Adv:Comp
марозней	марозна	Adv:Comp
марудлівей	марудліва	Adv:Comp
марудней	марудна	Adv:Comp
масіўней	масіўна	Adv:Comp
мяльчэй	мелка	Adv:Comp
мізэрней	мізэрна	Adv:Comp
мілагучней	мілагучна	Adv:Comp
мадней	модна	Adv:Comp
маладзей	молада	Adv:Comp
мужней	мужна	Adv:Comp
мутней	мутна	Adv:Comp
мякчэй	мякка	Adv:Comp
надзейней	надзейна	Adv:Comp
настырлівей	настырліва	Adv:Comp
настырней	настырна	Adv:Comp
небяспечней	небяспечна	Adv:Comp
непрыкметней	непрыкметна	Adv:Comp
непрыметней	непрыметна	Adv:Comp
несправядлівей	несправядліва	Adv:Comp
ніжэй	нізка	Adv:Comp
нудней	нудна	Adv:Comp
павальней	павольна	Adv:Comp
паганей	пагана	Adv:Comp
падрабязней	падрабязна	Adv:Comp
пажыўней	пажыўна	Adv:Comp
палымяней	палымяна	Adv:Comp
пампезней	пампезна	Adv:Comp
паслядоўней	паслядоўна	Adv:Comp
пацешней	пацешна	Adv:Comp
пачварней	пачварна	Adv:Comp
паэтычней	паэтычна	Adv:Comp
плаўней	плаўна	Adv:Comp
пазней	позна	Adv:Comp
паўней	поўна	Adv:Comp
правільней	правільна	Adv:Comp
прагрэсіўней	прагрэсіўна	Adv:Comp
прадуктыўней	прадуктыўна	Adv:Comp
прамей	прама	Adv:Comp
прастарней	прасторна	Adv:Comp
прасторней	прасторна	Adv:Comp
праўдзівей	праўдзіва	Adv:Comp
праціўней	праціўна	Adv:Comp
працяжней	працяжна	Adv:Comp
прывабней	прывабна	Adv:Comp
прыветлівей	прыветліва	Adv:Comp
прыветней	прыветна	Adv:Comp
прывольней	прывольна	Adv:Comp
прывычней	прывычна	Adv:Comp
прыемней	прыемна	Adv:Comp
прымітыўней	прымітыўна	Adv:Comp
прыстойней	прыстойна	Adv:Comp
прытарней	прытарна	Adv:Comp
пухлей	пухла	Adv:Comp
пыхлівей	пыхліва	Adv:Comp
пышней	пышна	Adv:Comp
пяшчотней	пяшчотна	Adv:Comp
радасней	радасна	Adv:Comp
разборлівей	разборліва	Adv:Comp
развязней	развязна	Adv:Comp
раздольней	раздольна	Adv:Comp
разнастайней	разнастайна	Adv:Comp
разумней	разумна	Adv:Comp
рамантычней	рамантычна	Adv:Comp
раскошней	раскошна	Adv:Comp
рацыянальней	рацыянальна	Adv:Comp
раўней	роўна	Adv:Comp
рухавей	рухава	Adv:Comp
рытмічней	рытмічна	Adv:Comp
рэальней	рэальна	Adv:Comp
рэгулярней	рэгулярна	Adv:Comp
радзей	рэдка	Adv:Comp
сакрэтней	сакрэтна	Adv:Comp
саладжавей	саладжава	Adv:Comp
саляней	салёна	Adv:Comp
саладзей	салодка	Adv:Comp
сарамлівей	сарамліва	Adv:Comp
сарамяжлівей	сарамяжліва	Adv:Comp
сардэчней	сардэчна	Adv:Comp
свабодней	свабодна	Adv:Comp
святочней	святочна	Adv:Comp
сентыментальней	сентыментальна	Adv:Comp
сімпатычней	сімпатычна	Adv:Comp
скваплівей	сквапліва	Adv:Comp
складаней	складана	Adv:Comp
складней	складна	Adv:Comp
скупей	скупа	Adv:Comp
слабей	слаба	Adv:Comp
слаўней	слаўна	Adv:Comp
смачней	смачна	Adv:Comp
смялей	смела	Adv:Comp
смяшней	смешна	Adv:Comp
саладзей	соладка	Adv:Comp
спажыўней	спажыўна	Adv:Comp
спакайней	спакойна	Adv:Comp
спакойней	спакойна	Adv:Comp
спялей	спела	Adv:Comp
справядлівей	справядліва	Adv:Comp
спраўней	спраўна	Adv:Comp
спрытней	спрытна	Adv:Comp
сталей	стала	Adv:Comp
старанней	старанна	Adv:Comp
страшней	страшна	Adv:Comp
стражэй	строга	Adv:Comp
страйней	стройна	Adv:Comp
стрыманей	стрымана	Adv:Comp
студзёней	студзёна	Adv:Comp
стэрыльней	стэрыльна	Adv:Comp
сумленней	сумленна	Adv:Comp
сумней	сумна	Adv:Comp
сур'ёзней	сур'ёзна	Adv:Comp
суровей	сурова	Adv:Comp
сушэй	суха	Adv:Comp
сытней	сытна	Adv:Comp
тактоўней	тактоўна	Adv:Comp
таленавіцей	таленавіта	Adv:Comp
танней	танна	Adv:Comp
тлусцей	тлуста	Adv:Comp
таней	тонка	Adv:Comp
танчэй	тонка	Adv:Comp
таўсцей	тоўста	Adv:Comp
трывожней	трывожна	Adv:Comp
тужэй	туга	Adv:Comp
тупей	тупа	Adv:Comp
удумлівей	удумліва	Adv:Comp
уедлівей	уедліва	Adv:Comp
утульней	утульна	Adv:Comp
фальшывей	фальшыва	Adv:Comp
хітрэй	хітра	Adv:Comp
хмурней	хмурна	Adv:Comp
халадней	холадна	Adv:Comp
харашэй	хораша	Adv:Comp
цвярдзей	цвёрда	Adv:Comp
цверазей	цвяроза	Adv:Comp
цямней	цёмна	Adv:Comp
цяплей	цёпла	Adv:Comp
цясней	цесна	Adv:Comp
цьмяней	цьмяна	Adv:Comp
чарней	чорна	Adv:Comp
чырваней	чырвана	Adv:Comp
шпарчэй	шпарка	Adv:Comp
шумней	шумна	Adv:Comp
шустрэй	шустра	Adv:Comp
шчаслівей	шчасліва	Adv:Comp
шчадрэй	шчодра	Adv:Comp
шчыльней	шчыльна	Adv:Comp
шчытней	шчытна	Adv:Comp
шыбчэй	шыбка	Adv:Comp
шыкарней	шыкарна	Adv:Comp
шыкоўней	шыкоўна	Adv:Comp
эканамічней	эканамічна	Adv:Comp
эканомней	эканомна	Adv:Comp
экстравагантней	экстравагантна	Adv:Comp
эластычней	эластычна	Adv:Comp
элементарней	элементарна	Adv:Comp
эмацыянальней	эмацыянальна	Adv:Comp
энергічней	энергічна	Adv:Comp
эратычней	эратычна	Adv:Comp
эстэтычней	эстэтычна	Adv:Comp
эфектней	эфектна	Adv:Comp
эфектыўней	эфектыўна	Adv:Comp
якасней	якасна	Adv:Comp
яскравей	яскрава	Adv:Comp
ясней	ясна	Adv:Comp
яхідней	яхідна	Adv:Comp

# Нет степеней сравнения

блізка	блізка	Adv
важна	важна	Adv
востра	востра	Adv
высока	высока	Adv
глыбока	глыбока	Adv
далёка	далёка	Adv
добра	добра	Adv
дорага	дорага	Adv
доўга	доўга	Adv
дробна	дробна	Adv
дрэнна	дрэнна	Adv
звонка	звонка	Adv
каротка	каротка	Adv
коратка	коратка	Adv
лёгка	лёгка	Adv
мала	мала	Adv
міла	міла	Adv
многа	многа	Adv
моцна	моцна	Adv
мудра	мудра	Adv
пільна	пільна	Adv
проста	проста	Adv
прыгожа	прыгожа	Adv
рана	рана	Adv
светла	светла	Adv
скора	скора	Adv
хутка	хутка	Adv
цікава	цікава	Adv
ціха	ціха	Adv
цяжка	цяжка	Adv
часта	часта	Adv
чыста	чыста	Adv
шырока	шырока	Adv
агідна	агідна	Adv
агрэсіўна	агрэсіўна	Adv
адважна	адважна	Adv
адказна	адказна	Adv
адэкватна	адэкватна	Adv
азартна	азартна	Adv
актыўна	актыўна	Adv
акуратна	акуратна	Adv
аператыўна	аператыўна	Adv
апетытна	апетытна	Adv
аптымальна	аптымальна	Adv
аптымістычна	аптымістычна	Adv
арганічна	арганічна	Adv
артыстычна	артыстычна	Adv
арыгінальна	арыгінальна	Adv
асцярожліва	асцярожліва	Adv
асцярожна	асцярожна	Adv
ахвотна	ахвотна	Adv
ашчадна	ашчадна	Adv
багата	багата	Adv
бедна	бедна	Adv
бела	бела	Adv
беражліва	беражліва	Adv
бескарысна	бескарысна	Adv
бесклапотна	бесклапотна	Adv
беспрасветна	беспрасветна	Adv
бесталкова	бесталкова	Adv
бесчалавечна	бесчалавечна	Adv
блажэнна	блажэнна	Adv
бойка	бойка	Adv
борзда	борзда	Adv
боязна	боязна	Adv
брудна	брудна	Adv
буйна	буйна	Adv
велізарна	велізарна	Adv
велічна	велічна	Adv
весела	весела	Adv
ветліва	ветліва	Adv
відавочна	відавочна	Adv
відно	відно	Adv
вільготна	вільготна	Adv
віртуозна	віртуозна	Adv
вольна	вольна	Adv
вузка	вузка	Adv
вульгарна	вульгарна	Adv
выбітна	выбітна	Adv
выгадна	выгадна	Adv
выдатна	выдатна	Adv
выйгрышна	выйгрышна	Adv
выразна	выразна	Adv
гарманічна	гарманічна	Adv
гаротна	гаротна	Adv
гарэзліва	гарэзліва	Adv
гарэзна	гарэзна	Adv
гасцінна	гасцінна	Adv
гладка	гладка	Adv
глуха	глуха	Adv
голадна	голадна	Adv
голасна	голасна	Adv
горача	горача	Adv
горка	горка	Adv
грацыёзна	грацыёзна	Adv
громка	громка	Adv
груба	груба	Adv
грунтоўна	грунтоўна	Adv
гуманна	гуманна	Adv
густа	густа	Adv
гучна	гучна	Adv
дакладна	дакладна	Adv
далікатна	далікатна	Adv
даступна	даступна	Adv
дасціпна	дасціпна	Adv
даўно	даўно	Adv
дзешава	дзешава	Adv
дружна	дружна	Adv
дужа	дужа	Adv
дурна	дурна	Adv
духмяна	духмяна	Adv
душна	душна	Adv
ёмка	ёмка	Adv
жаласліва	жаласліва	Adv
жаласна	жаласна	Adv
жалобна	жалобна	Adv
жвава	жвава	Adv
жудасна	жудасна	Adv
журботна	журботна	Adv
жыва	жыва	Adv
жывапісна	жывапісна	Adv
забаўна	забаўна	Adv
заможна	заможна	Adv
зграбна	зграбна	Adv
зелена	зелена	Adv
зладжана	зладжана	Adv
зручна	зручна	Adv
зырка	зырка	Adv
зычна	зычна	Adv
імкліва	імкліва	Adv
каларытна	каларытна	Adv
кампактна	кампактна	Adv
камфортна	камфортна	Adv
канкрэтна	канкрэтна	Adv
карысна	карысна	Adv
карэктна	карэктна	Adv
кісла	кісла	Adv
кругла	кругла	Adv
крута	крута	Adv
крыва	крыва	Adv
культурна	культурна	Adv
кур'ёзна	кур'ёзна	Adv
кучна	кучна	Adv
лагічна	лагічна	Adv
лагодна	лагодна	Adv
лаканічна	лаканічна	Adv
ласкава	ласкава	Adv
латва	латва	Adv
лаяльна	лаяльна	Adv
лірычна	лірычна	Adv
магутна	магутна	Adv
марозна	марозна	Adv
марудліва	марудліва	Adv
марудна	марудна	Adv
масіўна	масіўна	Adv
мелка	мелка	Adv
мізэрна	мізэрна	Adv
мілагучна	мілагучна	Adv
модна	модна	Adv
молада	молада	Adv
мужна	мужна	Adv
мутна	мутна	Adv
мякка	мякка	Adv
надзейна	надзейна	Adv
настырліва	настырліва	Adv
настырна	настырна	Adv
небяспечна	небяспечна	Adv
непрыкметна	непрыкметна	Adv
непрыметна	непрыметна	Adv
несправядліва	несправядліва	Adv
нізка	нізка	Adv
нудна	нудна	Adv
павольна	павольна	Adv
пагана	пагана	Adv
падрабязна	падрабязна	Adv
пажыўна	пажыўна	Adv
палымяна	палымяна	Adv
пампезна	пампезна	Adv
паслядоўна	паслядоўна	Adv
пацешна	пацешна	Adv
пачварна	пачварна	Adv
паэтычна	паэтычна	Adv
плаўна	плаўна	Adv
позна	позна	Adv
поўна	поўна	Adv
правільна	правільна	Adv
прагрэсіўна	прагрэсіўна	Adv
прадуктыўна	прадуктыўна	Adv
прама	прама	Adv
прасторна	прасторна	Adv
праўдзіва	праўдзіва	Adv
праціўна	праціўна	Adv
працяжна	працяжна	Adv
прывабна	прывабна	Adv
прыветліва	прыветліва	Adv
прыветна	прыветна	Adv
прывольна	прывольна	Adv
прывычна	прывычна	Adv
прыемна	прыемна	Adv
прымітыўна	прымітыўна	Adv
прыстойна	прыстойна	Adv
прытарна	прытарна	Adv
пухла	пухла	Adv
пыхліва	пыхліва	Adv
пышна	пышна	Adv
пяшчотна	пяшчотна	Adv
радасна	радасна	Adv
разборліва	разборліва	Adv
развязна	развязна	Adv
раздольна	раздольна	Adv
разнастайна	разнастайна	Adv
разумна	разумна	Adv
рамантычна	рамантычна	Adv
раскошна	раскошна	Adv
рацыянальна	рацыянальна	Adv
роўна	роўна	Adv
рухава	рухава	Adv
рытмічна	рытмічна	Adv
рэальна	рэальна	Adv
рэгулярна	рэгулярна	Adv
рэдка	рэдка	Adv
сакрэтна	сакрэтна	Adv
саладжава	саладжава	Adv
салёна	салёна	Adv
салодка	салодка	Adv
сарамліва	сарамліва	Adv
сарамяжліва	сарамяжліва	Adv
сардэчна	сардэчна	Adv
свабодна	свабодна	Adv
святочна	святочна	Adv
сентыментальна	сентыментальна	Adv
сімпатычна	сімпатычна	Adv
сквапліва	сквапліва	Adv
складана	складана	Adv
складна	складна	Adv
скупа	скупа	Adv
слаба	слаба	Adv
слаўна	слаўна	Adv
смачна	смачна	Adv
смела	смела	Adv
смешна	смешна	Adv
соладка	соладка	Adv
спажыўна	спажыўна	Adv
спакойна	спакойна	Adv
спела	спела	Adv
справядліва	справядліва	Adv
спраўна	спраўна	Adv
спрытна	спрытна	Adv
стала	стала	Adv
старанна	старанна	Adv
страшна	страшна	Adv
строга	строга	Adv
стройна	стройна	Adv
стрымана	стрымана	Adv
студзёна	студзёна	Adv
стэрыльна	стэрыльна	Adv
сумленна	сумленна	Adv
сумна	сумна	Adv
сур'ёзна	сур'ёзна	Adv
сурова	сурова	Adv
суха	суха	Adv
сытна	сытна	Adv
тактоўна	тактоўна	Adv
таленавіта	таленавіта	Adv
танна	танна	Adv
тлуста	тлуста	Adv
тонка	тонка	Adv
тоўста	тоўста	Adv
трывожна	трывожна	Adv
туга	туга	Adv
тупа	тупа	Adv
удумліва	удумліва	Adv
уедліва	уедліва	Adv
утульна	утульна	Adv
фальшыва	фальшыва	Adv
хітра	хітра	Adv
хмурна	хмурна	Adv
холадна	холадна	Adv
хораша	хораша	Adv
цвёрда	цвёрда	Adv
цвяроза	цвяроза	Adv
цёмна	цёмна	Adv
цёпла	цёпла	Adv
цесна	цесна	Adv
цьмяна	цьмяна	Adv
чорна	чорна	Adv
чырвана	чырвана	Adv
шпарка	шпарка	Adv
шумна	шумна	Adv
шустра	шустра	Adv
шчасліва	шчасліва	Adv
шчодра	шчодра	Adv
шчыльна	шчыльна	Adv
шчытна	шчытна	Adv
шыбка	шыбка	Adv
шыкарна	шыкарна	Adv
шыкоўна	шыкоўна	Adv
эканамічна	эканамічна	Adv
эканомна	эканомна	Adv
экстравагантна	экстравагантна	Adv
эластычна	эластычна	Adv
элементарна	элементарна	Adv
эмацыянальна	эмацыянальна	Adv
энергічна	энергічна	Adv
эратычна	эратычна	Adv
эстэтычна	эстэтычна	Adv
эфектна	эфектна	Adv
эфектыўна	эфектыўна	Adv
якасна	якасна	Adv
яскрава	яскрава	Adv
ясна	ясна	Adv
яхідна	яхідна	Adv
аб'ектыўна	аб'ектыўна	Adv
аб'ёмна	аб'ёмна	Adv
абавязкова	абавязкова	Adv
абапал	абапал	Adv
абаранкам	абаранкам	Adv
абачліва	абачліва	Adv
абаяльна	абаяльна	Adv
абвальна	абвальна	Adv
абгрунтавана	абгрунтавана	Adv
аберуч	аберуч	Adv
аберучкі	аберучкі	Adv
абмежавана	абмежавана	Adv
абнадзейліва	абнадзейліва	Adv
абразліва	абразліва	Adv
абрывіста	абрывіста	Adv
абсалютна	абсалютна	Adv
абстрактна	абстрактна	Adv
абсурдна	абсурдна	Adv
абуральна	абуральна	Adv
абурана	абурана	Adv
абыякава	абыякава	Adv
авансам	авансам	Adv
агідліва	агідліва	Adv
аглушальна	аглушальна	Adv
аглядна	аглядна	Adv
агніста	агніста	Adv
агулам	агулам	Adv
агульна	агульна	Adv
агульнавядома	агульнавядома	Adv
агульнапрызнана	агульнапрызнана	Adv
адабральна	адабральна	Adv
адажыа	адажыа	Adv
адваротна	адваротна	Adv
адвеку	адвеку	Adv
адвечна	адвечна	Adv
адвольна	адвольна	Adv
адвячоркам	адвячоркам	Adv
аддалена	аддалена	Adv
аддана	аддана	Adv
адзаду	адзаду	Adv
адзіна	адзіна	Adv
адзінаўладна	адзінаўладна	Adv
адзінока	адзінока	Adv
адкрыта	адкрыта	Adv
адмалку	адмалку	Adv
адменна	адменна	Adv
адметна	адметна	Adv
адміністрацыйна	адміністрацыйна	Adv
адмоўна	адмоўна	Adv
адмыслова	адмыслова	Adv
аднаасобна	аднаасобна	Adv
аднабакова	аднабакова	Adv
аднабока	аднабока	Adv
аднагалосна	аднагалосна	Adv
аднадушна	аднадушна	Adv
адназначна	адназначна	Adv
аднайменна	аднайменна	Adv
адналінейна	адналінейна	Adv
аднамерна	аднамерна	Adv
аднаразова	аднаразова	Adv
аднаруч	аднаруч	Adv
аднаслоўна	аднаслоўна	Adv
аднастайна	аднастайна	Adv
аднатонна	аднатонна	Adv
адначасна	адначасна	Adv
адначасова	адначасова	Adv
аднойчы	аднойчы	Adv
аднолькава	аднолькава	Adv
адносна	адносна	Adv
адпаведна	адпаведна	Adv
адразу	адразу	Adv
адрасна	адрасна	Adv
адрывачна	адрывачна	Adv
адрывіста	адрывіста	Adv
адурэла	адурэла	Adv
адхоніста	адхоніста	Adv
адхонна	адхонна	Adv
адцягнена	адцягнена	Adv
адчайна	адчайна	Adv
адчувальна	адчувальна	Adv
адчужана	адчужана	Adv
адыстар	адыстар	Adv
ажур	ажур	Adv
ажурна	ажурна	Adv
ажыўлена	ажыўлена	Adv
азлоблена	азлоблена	Adv
акадэмічна	акадэмічна	Adv
акамянела	акамянела	Adv
акордна	акордна	Adv
акрабатычна	акрабатычна	Adv
акрэслена	акрэслена	Adv
аксамітава	аксамітава	Adv
аксамітна	аксамітна	Adv
актуальна	актуальна	Adv
акурат	акурат	Adv
акуратненька	акуратненька	Adv
акустычна	акустычна	Adv
алгебраічна	алгебраічна	Adv
алегарычна	алегарычна	Adv
алегра	алегра	Adv
алегрэта	алегрэта	Adv
альпары	альпары	Adv
альсека	альсека	Adv
аляпавата	аляпавата	Adv
амаль	амаль	Adv
амаральна	амаральна	Adv
амбулаторна	амбулаторна	Adv
аналагічна	аналагічна	Adv
аналітычна	аналітычна	Adv
анамальна	анамальна	Adv
ананімна	ананімна	Adv
анархічна	анархічна	Adv
анатамічна	анатамічна	Adv
андантэ	андантэ	Adv
анекдатычна	анекдатычна	Adv
ані	ані	Adv
анізвання	анізвання	Adv
анкетна	анкетна	Adv
антыпедагагічна	антыпедагагічна	Adv
анфас	анфас	Adv
анямела	анямела	Adv
апазіцыйна	апазіцыйна	Adv
апантана	апантана	Adv
апартуністычна	апартуністычна	Adv
апасродкавана	апасродкавана	Adv
апастэрыёры	апастэрыёры	Adv
апатычна	апатычна	Adv
апаўдні	апаўдні	Adv
апаўночы	апаўночы	Adv
апашкі	апашкі	Adv
апоўдні	апоўдні	Adv
апоўначы	апоўначы	Adv
апраўдальна	апраўдальна	Adv
апрыёры	апрыёры	Adv
арганізавана	арганізавана	Adv
арганізацыйна	арганізацыйна	Adv
аргументавана	аргументавана	Adv
арпеджыа	арпеджыа	Adv
артадаксальна	артадаксальна	Adv
артраскапічна	артраскапічна	Adv
архаічна	архаічна	Adv
архітэктурна	архітэктурна	Adv
арцельна	арцельна	Adv
арыенціровачна	арыенціровачна	Adv
арыстакратычна	арыстакратычна	Adv
арыфметычна	арыфметычна	Adv
арэхава	арэхава	Adv
арэшкава	арэшкава	Adv
асабіста	асабіста	Adv
асабліва	асабліва	Adv
асабняком	асабняком	Adv
асавела	асавела	Adv
асалавела	асалавела	Adv
асацыятыўна	асацыятыўна	Adv
асіметрычна	асіметрычна	Adv
асірацела	асірацела	Adv
асляпляльна	асляпляльна	Adv
асобна	асобна	Adv
астматычна	астматычна	Adv
асуджальна	асуджальна	Adv
асцярожненька	асцярожненька	Adv
асэнсавана	асэнсавана	Adv
атарапела	атарапела	Adv
аўтаматычна	аўтаматычна	Adv
аўтаномна	аўтаномна	Adv
аўтарытэтна	аўтарытэтна	Adv
афарыстычна	афарыстычна	Adv
афіцыйна	афіцыйна	Adv
ахайна	ахайна	Adv
ахвоча	ахвоча	Adv
ахвярна	ахвярна	Adv
ахоўна	ахоўна	Adv
ачмурэла	ачмурэла	Adv
ашаламляльна	ашаламляльна	Adv
ашалела	ашалела	Adv
ашчадліва	ашчадліва	Adv
бадай	бадай	Adv
бадзёра	бадзёра	Adv
балбатліва	балбатліва	Adv
балесна	балесна	Adv
балюча	балюча	Adv
банальна	банальна	Adv
басавіта	басавіта	Adv
басанож	басанож	Adv
басіста	басіста	Adv
баязліва	баязліва	Adv
бегла	бегла	Adv
бегма	бегма	Adv
беднавата	беднавата	Adv
безабаронна	безабаронна	Adv
безаблічна	безаблічна	Adv
безаварыйна	безаварыйна	Adv
безагаворачна	безагаворачна	Adv
безаглядна	безаглядна	Adv
безадвальна	безадвальна	Adv
безадгаворачна	безадгаворачна	Adv
безадказна	безадказна	Adv
безадкладна	безадкладна	Adv
безадмоўна	безадмоўна	Adv
безадносна	безадносна	Adv
безадрыўна	безадрыўна	Adv
безальтэрнатыўна	безальтэрнатыўна	Adv
безапеляцыйна	безапеляцыйна	Adv
безасабова	безасабова	Adv
безвынікова	безвынікова	Adv
безвыходна	безвыходна	Adv
безгалоса	безгалоса	Adv
безгаспадарліва	безгаспадарліва	Adv
безгаспадарна	безгаспадарна	Adv
безгаспадарча	безгаспадарча	Adv
безгрунтоўна	безгрунтоўна	Adv
безгустоўна	безгустоўна	Adv
бездакорна	бездакорна	Adv
бездапаможна	бездапаможна	Adv
безжурботна	безжурботна	Adv
беззабаронна	беззабаронна	Adv
беззаганна	беззаганна	Adv
беззаконна	беззаконна	Adv
беззапаветна	беззапаветна	Adv
беззваротна	беззваротна	Adv
беззмястоўна	беззмястоўна	Adv
безліч	безліч	Adv
безнаглядна	безнаглядна	Adv
безнадзейна	безнадзейна	Adv
безразважна	безразважна	Adv
безуважліва	безуважліва	Adv
безуважна	безуважна	Adv
безудзельна	безудзельна	Adv
безуладна	безуладна	Adv
безумоўна	безумоўна	Adv
безупынку	безупынку	Adv
безупынна	безупынна	Adv
безуцешна	безуцешна	Adv
безыдэйна	безыдэйна	Adv
белазуба	белазуба	Adv
бескалярова	бескалярова	Adv
бескампрамісна	бескампрамісна	Adv
бескантрольна	бескантрольна	Adv
бескарысліва	бескарысліва	Adv
беспаваротна	беспаваротна	Adv
беспадстаўна	беспадстаўна	Adv
беспакарана	беспакарана	Adv
беспамылкова	беспамылкова	Adv
беспарадкава	беспарадкава	Adv
беспарадна	беспарадна	Adv
беспардонна	беспардонна	Adv
беспаспяхова	беспаспяхова	Adv
беспатэнтна	беспатэнтна	Adv
бесперабойна	бесперабойна	Adv
беспераменна	беспераменна	Adv
бесперапынку	бесперапынку	Adv
бесперапынна	бесперапынна	Adv
бесперастанку	бесперастанку	Adv
бесперастанна	бесперастанна	Adv
бесперашкодна	бесперашкодна	Adv
бесперспектыўна	бесперспектыўна	Adv
беспрабудна	беспрабудна	Adv
беспрыбыткова	беспрыбыткова	Adv
беспрынцыпова	беспрынцыпова	Adv
беспрытомна	беспрытомна	Adv
беспрытульна	беспрытульна	Adv
беспрычынна	беспрычынна	Adv
беспрэцэдэнтна	беспрэцэдэнтна	Adv
беспярэчна	беспярэчна	Adv
бессардэчна	бессардэчна	Adv
бессаромна	бессаромна	Adv
бессаслоўна	бессаслоўна	Adv
бессвядома	бессвядома	Adv
бессімптомна	бессімптомна	Adv
бессістэмна	бессістэмна	Adv
бесстаронна	бесстаронна	Adv
бесструктурна	бесструктурна	Adv
бессэнсоўна	бессэнсоўна	Adv
бестактоўна	бестактоўна	Adv
бестурботна	бестурботна	Adv
бестэрмінова	бестэрмінова	Adv
бесцырымонна	бесцырымонна	Adv
бірузова	бірузова	Adv
бітком	бітком	Adv
біялагічна	біялагічна	Adv
блага	блага	Adv
блазнавата	блазнавата	Adv
блакітна	блакітна	Adv
бледна	бледна	Adv
бледнавата	бледнавата	Adv
бліжай	бліжай	Adv
бліжэй	бліжэй	Adv
блізарука	блізарука	Adv
блізенечка	блізенечка	Adv
блізенька	блізенька	Adv
блізютка	блізютка	Adv
бліскуча	бліскуча	Adv
блытана	блытана	Adv
бляшана	бляшана	Adv
бобрыкам	бобрыкам	Adv
больш-менш	больш-менш	Adv
борздзенька	борздзенька	Adv
брава	брава	Adv
бравурна	бравурна	Adv
бруднавата	бруднавата	Adv
брыдка	брыдка	Adv
брыдотна	брыдотна	Adv
будзённа	будзённа	Adv
бурачкова	бурачкова	Adv
буркатліва	буркатліва	Adv
буркліва	буркліва	Adv
бурліва	бурліва	Adv
бурна	бурна	Adv
бучна	бучна	Adv
буяна	буяна	Adv
бюракратычна	бюракратычна	Adv
бягом	бягом	Adv
бядотна	бядотна	Adv
бязбожна	бязбожна	Adv
бязбольна	бязбольна	Adv
бязбоязна	бязбоязна	Adv
бязветрана	бязветрана	Adv
бязвінна	бязвінна	Adv
бязвоблачна	бязвоблачна	Adv
бязвольна	бязвольна	Adv
бязвыезна	бязвыезна	Adv
бязвылазна	бязвылазна	Adv
бязвыплатна	бязвыплатна	Adv
бязвыхадна	бязвыхадна	Adv
бязглузда	бязглузда	Adv
бязгрэшна	бязгрэшна	Adv
бязгучна	бязгучна	Adv
бяздарна	бяздарна	Adv
бяздзейна	бяздзейна	Adv
бяздоказна	бяздоказна	Adv
бяздомна	бяздомна	Adv
бяздумна	бяздумна	Adv
бяздушна	бяздушна	Adv
бяздымна	бяздымна	Adv
бяззуба	бяззуба	Adv
бязладна	бязладна	Adv
бязлітасна	бязлітасна	Adv
бязлюдна	бязлюдна	Adv
бязмала	бязмала	Adv
бязмежна	бязмежна	Adv
бязмерна	бязмерна	Adv
бязмоўна	бязмоўна	Adv
бязмытна	бязмытна	Adv
бязмэтна	бязмэтна	Adv
бязрадасна	бязрадасна	Adv
бялютка	бялютка	Adv
бяскарна	бяскарна	Adv
бясколерна	бясколерна	Adv
бясконца	бясконца	Adv
бяскрыўдна	бяскрыўдна	Adv
бяспечна	бяспечна	Adv
бяспланава	бяспланава	Adv
бясплатна	бясплатна	Adv
бясплённа	бясплённа	Adv
бяспошлінна	бяспошлінна	Adv
бяспраўна	бяспраўна	Adv
бяспрыкладна	бяспрыкладна	Adv
бяссільна	бяссільна	Adv
бясслаўна	бясслаўна	Adv
бясследна	бясследна	Adv
бясслёзна	бясслёзна	Adv
бяссонна	бяссонна	Adv
бясспрэчна	бясспрэчна	Adv
бясстрасна	бясстрасна	Adv
бясстратна	бясстратна	Adv
бясстрашна	бясстрашна	Adv
бяссэнсава	бяссэнсава	Adv
бяссэнсна	бяссэнсна	Adv
бястактна	бястактна	Adv
бясхмарна	бясхмарна	Adv
бясшкодна	бясшкодна	Adv
бясшумна	бясшумна	Adv
вабна	вабна	Adv
вавекі	вавекі	Adv
важка	важка	Adv
вакол	вакол	Adv
валадарна	валадарна	Adv
валам	валам	Adv
вантробна	вантробна	Adv
варожа	варожа	Adv
васількова	васількова	Adv
ваўкавата	ваўкавата	Adv
ваяўніча	ваяўніча	Adv
вегетатыўна	вегетатыўна	Adv
ведама	ведама	Adv
веерам	веерам	Adv
векавечна	векавечна	Adv
велікадушна	велікадушна	Adv
вельмі	вельмі	Adv
верагодна	верагодна	Adv
вераломна	вераломна	Adv
вераснёва	вераснёва	Adv
верна	верна	Adv
вёртка	вёртка	Adv
вертыкальна	вертыкальна	Adv
ветла	ветла	Adv
ветрана	ветрана	Adv
вечарам	вечарам	Adv
вечарком	вечарком	Adv
вечарова	вечарова	Adv
вечна	вечна	Adv
вібрата	вібрата	Adv
віднавата	віднавата	Adv
віднюсенька	віднюсенька	Adv
віднютка	віднютка	Adv
відовішчна	відовішчна	Adv
відочна	відочна	Adv
візуальна	візуальна	Adv
вінавата	вінавата	Adv
вінтом	вінтом	Adv
вірліва	вірліва	Adv
віртуальна	віртуальна	Adv
віскліва	віскліва	Adv
вітальна	вітальна	Adv
віхрам	віхрам	Adv
вобзем	вобзем	Adv
вобземлю	вобземлю	Adv
вобмаль	вобмаль	Adv
вобмацкам	вобмацкам	Adv
вобмельгам	вобмельгам	Adv
вобразна	вобразна	Adv
вогненебяспечна	вогненебяспечна	Adv
воддалек	воддалек	Adv
воддаль	воддаль	Adv
вожыкам	вожыкам	Adv
вокал	вокал	Adv
вокала	вокала	Adv
вокамгненна	вокамгненна	Adv
волакам	волакам	Adv
волка	волка	Adv
воляй-няволяй	воляй-няволяй	Adv
вон	вон	Adv
вонкава	вонкава	Adv
вонкі	вонкі	Adv
вопрамеццю	вопрамеццю	Adv
вопытна	вопытна	Adv
вось-вось	вось-вось	Adv
воўкам	воўкам	Adv
вульгарызавана	вульгарызавана	Adv
вусна	вусна	Adv
вусцішна	вусцішна	Adv
выбарачна	выбарачна	Adv
выбарна	выбарна	Adv
выбухова	выбухова	Adv
выгодна	выгодна	Adv
вызначальна	вызначальна	Adv
выкрутліва	выкрутліва	Adv
вымушана	вымушана	Adv
вынаходліва	вынаходліва	Adv
вынікова	вынікова	Adv
выпадкова	выпадкова	Adv
выпрабавальна	выпрабавальна	Adv
выпукла	выпукла	Adv
выратавальна	выратавальна	Adv
высакавата	высакавата	Adv
высакамерна	высакамерна	Adv
высакамоўна	высакамоўна	Adv
высакародна	высакародна	Adv
высакаякасна	высакаякасна	Adv
высокапрафесійна	высокапрафесійна	Adv
высокенька	высокенька	Adv
выхвальна	выхвальна	Adv
вычарпальна	вычарпальна	Adv
вычварна	вычварна	Adv
вышай	вышай	Adv
выяўна	выяўна	Adv
вядома	вядома	Adv
вялікасна	вялікасна	Adv
вяртлява	вяртлява	Adv
вярхом	вярхом	Adv
вясной	вясной	Adv
вясною	вясною	Adv
гаварліва	гаварліва	Adv
гадамі	гадамі	Adv
гадзінамі	гадзінамі	Adv
гадка	гадка	Adv
гадліва	гадліва	Adv
галавакружна	галавакружна	Adv
галаднавата	галаднавата	Adv
галантна	галантна	Adv
галаруч	галаруч	Adv
галасіста	галасіста	Adv
галаслоўна	галаслоўна	Adv
галодна	галодна	Adv
галосна	галосна	Adv
галышом	галышом	Adv
гаманліва	гаманліва	Adv
гамузам	гамузам	Adv
ганарліва	ганарліва	Adv
ганарова	ганарова	Adv
ганарыста	ганарыста	Adv
ганебна	ганебна	Adv
ганорна	ганорна	Adv
гарачліва	гарачліва	Adv
гаркотна	гаркотна	Adv
гарманальна	гарманальна	Adv
гармідарна	гармідарна	Adv
гартанна	гартанна	Adv
гарызантальна	гарызантальна	Adv
гаспадарліва	гаспадарліва	Adv
гаспадарна	гаспадарна	Adv
гаспадарча	гаспадарча	Adv
гатова	гатова	Adv
гаюча	гаюча	Adv
гвалтоўна	гвалтоўна	Adv
геаграфічна	геаграфічна	Adv
геаметрычна	геаметрычна	Adv
генетычна	генетычна	Adv
геніяльна	геніяльна	Adv
гераічна	гераічна	Adv
геральдычна	геральдычна	Adv
гермафрадытычна	гермафрадытычна	Adv
герметычна	герметычна	Adv
гібельна	гібельна	Adv
гідліва	гідліва	Adv
гіпатэтычна	гіпатэтычна	Adv
гіпербалічна	гіпербалічна	Adv
гіпнатычна	гіпнатычна	Adv
гістарычна	гістарычна	Adv
глабальна	глабальна	Adv
глейка	глейка	Adv
глухавата	глухавата	Adv
глыбакавата	глыбакавата	Adv
глыбакадумна	глыбакадумна	Adv
глыбінна	глыбінна	Adv
гнеўна	гнеўна	Adv
гнутка	гнутка	Adv
гнюсна	гнюсна	Adv
гнятліва	гнятліва	Adv
гняўліва	гняўліва	Adv
годзе	годзе	Adv
годна	годна	Adv
гола	гола	Adv
гонка	гонка	Adv
горай	горай	Adv
горда	горда	Adv
горна	горна	Adv
горш	горш	Adv
градам	градам	Adv
гразка	гразка	Adv
гразкавата	гразкавата	Adv
граматычна	граматычна	Adv
грандыёзна	грандыёзна	Adv
гранічна	гранічна	Adv
графічна	графічна	Adv
грахоўна	грахоўна	Adv
грозна	грозна	Adv
грубавата	грубавата	Adv
грузна	грузна	Adv
грузнавата	грузнавата	Adv
грукатліва	грукатліва	Adv
грымотна	грымотна	Adv
грэбліва	грэбліва	Adv
грэшна	грэшна	Adv
гугнява	гугнява	Adv
гужам	гужам	Adv
гулка	гулка	Adv
гулліва	гулліва	Adv
гультайліва	гультайліва	Adv
гультаявата	гультаявата	Adv
гуманітарна	гуманітарна	Adv
гумарыстычна	гумарыстычна	Adv
густавата	густавата	Adv
густоўна	густоўна	Adv
гуськом	гуськом	Adv
даастатку	даастатку	Adv
дабравольна	дабравольна	Adv
дабрадзейна	дабрадзейна	Adv
дабрадушна	дабрадушна	Adv
дабратворна	дабратворна	Adv
дабратліва	дабратліва	Adv
дабрачынна	дабрачынна	Adv
дабраякасна	дабраякасна	Adv
дабром	дабром	Adv
дабротна	дабротна	Adv
дабяла	дабяла	Adv
давеку	давеку	Adv
даверліва	даверліва	Adv
даверху	даверху	Adv
давідна	давідна	Adv
даволі	даволі	Adv
давольна	давольна	Adv
дагадліва	дагадліва	Adv
дагала	дагала	Adv
дагары	дагары	Adv
дагматычна	дагматычна	Adv
дагодліва	дагодліва	Adv
дадаткова	дадаткова	Adv
дадатна	дадатна	Adv
дадолу	дадолу	Adv
дадому	дадому	Adv
дадушы	дадушы	Adv
дажаўта	дажаўта	Adv
дажджом	дажджом	Adv
дазарэзу	дазарэзу	Adv
дазваляльна	дазваляльна	Adv
дазвання	дазвання	Adv
дазволена	дазволена	Adv
дакорліва	дакорліва	Adv
дакорна	дакорна	Adv
дакументальна	дакументальна	Adv
дакучліва	дакучліва	Adv
далёка-далёка	далёка-далёка	Adv
далекавата	далекавата	Adv
далоў	далоў	Adv
дальнабачна	дальнабачна	Adv
дамоў	дамоў	Adv
данізу	данізу	Adv
дапазна	дапазна	Adv
дапаўна	дапаўна	Adv
дапраўды	дапраўды	Adv
дапушчальна	дапушчальна	Adv
дапытліва	дапытліва	Adv
даравальна	даравальна	Adv
дарагавата	дарагавата	Adv
дарма	дарма	Adv
дармова	дармова	Adv
дарогай	дарогай	Adv
дарэмна	дарэмна	Adv
дарэчна	дарэчна	Adv
дарэчы	дарэчы	Adv
дарэшты	дарэшты	Adv
дасадліва	дасадліва	Adv
дасведчана	дасведчана	Adv
дасканала	дасканала	Adv
даслоўна	даслоўна	Adv
даспадобы	даспадобы	Adv
дастаткова	дастаткова	Adv
дастойна	дастойна	Adv
дасуха	дасуха	Adv
дасыта	дасыта	Adv
даткліва	даткліва	Adv
датла	датла	Adv
датычна	датычна	Adv
датэрмінова	датэрмінова	Adv
даўгавата	даўгавата	Adv
даўгавечна	даўгавечна	Adv
даўка	даўка	Adv
даўнавата	даўнавата	Adv
даўней	даўней	Adv
даўненька	даўненька	Adv
даўным-даўно	даўным-даўно	Adv
даўнютка	даўнютка	Adv
дахаты	дахаты	Adv
даходліва	даходліва	Adv
дацямна	дацямна	Adv
дачасна	дачасна	Adv
дачырвана	дачырвана	Adv
дачыста	дачыста	Adv
дашчэнту	дашчэнту	Adv
даясна	даясна	Adv
дбайна	дбайна	Adv
дбала	дбала	Adv
дваяка	дваяка	Adv
двойчы	двойчы	Adv
двудушна	двудушна	Adv
дзейна	дзейна	Adv
дзейсна	дзейсна	Adv
дзелавіта	дзелавіта	Adv
дзённа	дзённа	Adv
дзёрзка	дзёрзка	Adv
дзесяцікратна	дзесяцікратна	Adv
дзівакавата	дзівакавата	Adv
дзівачліва	дзівачліва	Adv
дзівосна	дзівосна	Adv
дзіка	дзіка	Adv
дзікавата	дзікавата	Adv
дзіўна	дзіўна	Adv
дзіўнавата	дзіўнавата	Adv
дзяжурна	дзяжурна	Adv
дзяржаўна	дзяржаўна	Adv
днём	днём	Adv
днямі	днямі	Adv
доблесна	доблесна	Adv
добраахвотна	добраахвотна	Adv
добразычліва	добразычліва	Adv
добранадзейна	добранадзейна	Adv
добранамерна	добранамерна	Adv
добрапрыстойна	добрапрыстойна	Adv
добрасумленна	добрасумленна	Adv
доказна	доказна	Adv
долам	долам	Adv
долу	долу	Adv
досвета	досвета	Adv
досвіткам	досвіткам	Adv
досуха	досуха	Adv
досыць	досыць	Adv
доўгатэрмінова	доўгатэрмінова	Adv
драбнавата	драбнавата	Adv
драматычна	драматычна	Adv
драпежна	драпежна	Adv
дробава	дробава	Adv
дробязна	дробязна	Adv
дрогка	дрогка	Adv
другарадна	другарадна	Adv
другасна	другасна	Adv
дружалюбна	дружалюбна	Adv
дрыгатліва	дрыгатліва	Adv
дрыготка	дрыготка	Adv
дрымотна	дрымотна	Adv
дуба	дуба	Adv
дубам	дубам	Adv
дубка	дубка	Adv
дугападобна	дугападобна	Adv
дугой	дугой	Adv
дурасліва	дурасліва	Adv
дурманліва	дурманліва	Adv
духоўна	духоўна	Adv
душнавата	душнавата	Adv
душэўна	душэўна	Adv
дымна	дымна	Adv
дынамічна	дынамічна	Adv
дыпламатычна	дыпламатычна	Adv
дыскамфортна	дыскамфортна	Adv
дысцыплінарна	дысцыплінарна	Adv
дыхтоўна	дыхтоўна	Adv
дыяганальна	дыяганальна	Adv
дыялектычна	дыялектычна	Adv
дыяметральна	дыяметральна	Adv
дэ-факта	дэ-факта	Adv
дэ-юрэ	дэ-юрэ	Adv
дэкаратыўна	дэкаратыўна	Adv
дэкларатыўна	дэкларатыўна	Adv
дэмагагічна	дэмагагічна	Adv
дэмакратычна	дэмакратычна	Adv
дэманічна	дэманічна	Adv
дэманстратыўна	дэманстратыўна	Adv
дэспатычна	дэспатычна	Adv
дэструктыўна	дэструктыўна	Adv
дэталёва	дэталёва	Adv
дэтальна	дэтальна	Adv
едка	едка	Adv
ёміста	ёміста	Adv
епіскапальна	епіскапальна	Adv
еўрапеоідна	еўрапеоідна	Adv
жалезна	жалезна	Adv
жалліва	жалліва	Adv
жарсткавата	жарсткавата	Adv
жартаўліва	жартаўліва	Adv
жартліва	жартліва	Adv
жартоўна	жартоўна	Adv
жаўтлява	жаўтлява	Adv
жахліва	жахліва	Adv
жорстка	жорстка	Adv
жоўта	жоўта	Adv
жулікавата	жулікавата	Adv
журліва	журліва	Adv
жывасілам	жывасілам	Adv
жыўцом	жыўцом	Adv
жыццёва	жыццёва	Adv
жыццесцвярджальна	жыццесцвярджальна	Adv
жыццярадасна	жыццярадасна	Adv
з'едліва	з'едліва	Adv
заадно	заадно	Adv
завабліва	завабліва	Adv
завабна	завабна	Adv
заварожана	заварожана	Adv
заведама	заведама	Adv
завельмі	завельмі	Adv
завідна	завідна	Adv
завочна	завочна	Adv
завочы	завочы	Adv
завысока	завысока	Adv
загадзя	загадзя	Adv
загадкава	загадкава	Adv
загадна	загадна	Adv
заганна	заганна	Adv
загуста	загуста	Adv
задаволена	задаволена	Adv
задарам	задарам	Adv
задарма	задарма	Adv
задзірліва	задзірліва	Adv
задзірыста	задзірыста	Adv
задорага	задорага	Adv
задорна	задорна	Adv
задоўга	задоўга	Adv
задужа	задужа	Adv
задумана	задумана	Adv
задуменна	задуменна	Adv
задумліва	задумліва	Adv
задушліва	задушліва	Adv
задушэўна	задушэўна	Adv
задыхана	задыхана	Adv
зажыва	зажыва	Adv
зазвычай	зазвычай	Adv
зазыўна	зазыўна	Adv
зайздросліва	зайздросліва	Adv
зайздросна	зайздросна	Adv
займальна	займальна	Adv
заканадаўча	заканадаўча	Adv
заканамерна	заканамерна	Adv
закахана	закахана	Adv
законна	законна	Adv
залаціста	залаціста	Adv
залетась	залетась	Adv
залівіста	залівіста	Adv
залішне	залішне	Adv
залпам	залпам	Adv
замагільна	замагільна	Adv
замала	замала	Adv
замалада	замалада	Adv
заманліва	заманліва	Adv
замашна	замашна	Adv
замілавальна	замілавальна	Adv
замнога	замнога	Adv
замоцна	замоцна	Adv
замуж	замуж	Adv
замужам	замужам	Adv
занава	занава	Adv
занадта	занадта	Adv
занач	занач	Adv
занізка	занізка	Adv
занудліва	занудліва	Adv
запаволена	запаволена	Adv
запагадзь	запагадзь	Adv
запальна	запальна	Adv
запальчыва	запальчыва	Adv
запамінальна	запамінальна	Adv
запанібрата	запанібрата	Adv
запар	запар	Adv
заплеччу	заплеччу	Adv
запоем	запоем	Adv
запозна	запозна	Adv
запознена	запознена	Adv
запрашальна	запрашальна	Adv
запытальна	запытальна	Adv
зараз	зараз	Adv
заразліва	заразліва	Adv
зарана	зарана	Adv
зараней	зараней	Adv
зарэзка	зарэзка	Adv
засаб	засаб	Adv
засаромлена	засаромлена	Adv
засветла	засветла	Adv
заслабка	заслабка	Adv
заслужана	заслужана	Adv
засмучана	засмучана	Adv
заспакаяльна	заспакаяльна	Adv
заспана	заспана	Adv
засяроджана	засяроджана	Adv
затанна	затанна	Adv
затоена	затоена	Adv
затхла	затхла	Adv
заўгодна	заўгодна	Adv
заўзята	заўзята	Adv
заўтра	заўтра	Adv
заўчасна	заўчасна	Adv
заўчора	заўчора	Adv
захапляльна	захапляльна	Adv
захапляюча	захапляюча	Adv
зацемна	зацемна	Adv
зацепла	зацепла	Adv
зацёпла	зацёпла	Adv
зацікаўлена	зацікаўлена	Adv
зацішна	зацішна	Adv
зацята	зацята	Adv
зачаравана	зачаравана	Adv
зашмат	зашмат	Adv
зашырока	зашырока	Adv
заядла	заядла	Adv
зблізку	зблізку	Adv
збоку	збоку	Adv
збольшага	збольшага	Adv
збоч	збоч	Adv
звабліва	звабліва	Adv
зважна	зважна	Adv
звеку	звеку	Adv
зверху	зверху	Adv
звечара	звечара	Adv
звідна	звідна	Adv
зводдалеку	зводдалеку	Adv
звонкагалоса	звонкагалоса	Adv
звонку	звонку	Adv
звыкла	звыкла	Adv
звысоку	звысоку	Adv
звычайна	звычайна	Adv
звычна	звычна	Adv
звышмодна	звышмодна	Adv
звышнатуральна	звышнатуральна	Adv
звышурочна	звышурочна	Adv
звягліва	звягліва	Adv
звязна	звязна	Adv
згары	згары	Adv
згодна	згодна	Adv
згубна	згубна	Adv
згуртавана	згуртавана	Adv
здавальняюча	здавальняюча	Adv
здавен	здавен	Adv
здавён	здавён	Adv
здавён-даўна	здавён-даўна	Adv
здаволена	здаволена	Adv
здагадліва	здагадліва	Adv
здалёк	здалёк	Adv
здалёку	здалёку	Adv
здаля	здаля	Adv
здарма	здарма	Adv
здаўлена	здаўлена	Adv
здаўна	здаўна	Adv
здаўных-даўна	здаўных-даўна	Adv
здзекліва	здзекліва	Adv
здзельна	здзельна	Adv
здзіўлена	здзіўлена	Adv
здзіўляюча	здзіўляюча	Adv
здорава	здорава	Adv
здрадліва	здрадліва	Adv
здуру	здуру	Adv
зеленавата	зеленавата	Adv
ззаду	ззаду	Adv
ззамаладу	ззамаладу	Adv
зігзагам	зігзагам	Adv
зімна	зімна	Adv
зімой	зімой	Adv
зімою	зімою	Adv
злавесна	злавесна	Adv
зладзеявата	зладзеявата	Adv
зламысна	зламысна	Adv
зларадна	зларадна	Adv
зласліва	зласліва	Adv
злачынна	злачынна	Adv
злева	злева	Adv
злёгку	злёгку	Adv
злосна	злосна	Adv
змалку	змалку	Adv
зманліва	зманліва	Adv
змоладу	змоладу	Adv
зморана	зморана	Adv
змрокам	змрокам	Adv
змрочна	змрочна	Adv
змушана	змушана	Adv
змястоўна	змястоўна	Adv
знадворку	знадворку	Adv
знакава	знакава	Adv
знарок	знарок	Adv
знарочыста	знарочыста	Adv
знаходліва	знаходліва	Adv
значна	значна	Adv
зневажальна	зневажальна	Adv
знешне	знешне	Adv
знізу	знізу	Adv
знішчальна	знішчальна	Adv
зноў	зноў	Adv
зноўку	зноўку	Adv
знутры	знутры	Adv
зняважліва	зняважліва	Adv
знямогла	знямогла	Adv
зняможана	зняможана	Adv
знянацку	знянацку	Adv
знясілена	знясілена	Adv
зняўцерпу	зняўцерпу	Adv
знячэўку	знячэўку	Adv
золка	золка	Adv
зорка	зорка	Adv
зорна	зорна	Adv
зразу	зразу	Adv
зразумела	зразумела	Adv
зранку	зранку	Adv
зрання	зрання	Adv
зроду	зроду	Adv
зрукі	зрукі	Adv
зрэдку	зрэдку	Adv
зухавата	зухавата	Adv
зычліва	зычліва	Adv
зябка	зябка	Adv
зярніста	зярніста	Adv
ідылічна	ідылічна	Adv
ідэалагічна	ідэалагічна	Adv
ідэалістычна	ідэалістычна	Adv
ідэальна	ідэальна	Adv
ідэйна	ідэйна	Adv
ідэнтычна	ідэнтычна	Adv
ізалявана	ізалявана	Adv
ізноў	ізноў	Adv
ілжыва	ілжыва	Adv
ільготна	ільготна	Adv
ілюзорна	ілюзорна	Adv
імаверна	імаверна	Adv
іманентна	іманентна	Adv
імгліста	імгліста	Adv
імгненна	імгненна	Adv
імпазантна	імпазантна	Adv
імператыўна	імператыўна	Adv
імпліцытна	імпліцытна	Adv
імправізацыйна	імправізацыйна	Adv
імпрэсіўна	імпрэсіўна	Adv
імпрэсіяністычна	імпрэсіяністычна	Adv
імпульсіўна	імпульсіўна	Adv
імпэтна	імпэтна	Adv
ін-кварта	ін-кварта	Adv
інавацыйна	інавацыйна	Adv
інвестыцыйна	інвестыцыйна	Adv
індустрыяльна	індустрыяльна	Adv
індывідуалістычна	індывідуалістычна	Adv
індывідуальна	індывідуальна	Adv
індыкатыўна	індыкатыўна	Adv
індыферэнтна	індыферэнтна	Adv
інертна	інертна	Adv
інжынерна	інжынерна	Adv
ініцыятыўна	ініцыятыўна	Adv
інкогніта	інкогніта	Adv
інстыктыўна	інстыктыўна	Adv
інстынктыўна	інстынктыўна	Adv
інтанацыйна	інтанацыйна	Adv
інтуітыўна	інтуітыўна	Adv
інтымна	інтымна	Adv
інтэлектуальна	інтэлектуальна	Adv
інтэлігентна	інтэлігентна	Adv
інтэнсіўна	інтэнсіўна	Adv
інфантыльна	інфантыльна	Adv
інфармацыйна	інфармацыйна	Adv
іншасказальна	іншасказальна	Adv
іранічна	іранічна	Adv
ірдзяна	ірдзяна	Adv
іскрыста	іскрыста	Adv
істотна	істотна	Adv
істэрычна	істэрычна	Adv
ісцінна	ісцінна	Adv
кагадзе	кагадзе	Adv
кагалам	кагалам	Adv
казачна	казачна	Adv
казённа	казённа	Adv
казуістычна	казуістычна	Adv
казытліва	казытліва	Adv
какетліва	какетліва	Adv
каламутна	каламутна	Adv
каласальна	каласальна	Adv
калегіяльна	калегіяльна	Adv
калейдаскапічна	калейдаскапічна	Adv
калектыўна	калектыўна	Adv
каліграфічна	каліграфічна	Adv
калісь	калісь	Adv
калісьці	калісьці	Adv
калюча	калюча	Adv
каменна	каменна	Adv
камерна	камерна	Adv
камерцыйна	камерцыйна	Adv
камільфо	камільфо	Adv
камічна	камічна	Adv
кампазіцыйна	кампазіцыйна	Adv
кампетэнтна	кампетэнтна	Adv
камфартабельна	камфартабельна	Adv
кананічна	кананічна	Adv
канвульсіўна	канвульсіўна	Adv
кандзібоберам	кандзібоберам	Adv
канечне	канечне	Adv
канешне	канешне	Adv
кансерватыўна	кансерватыўна	Adv
канспіратыўна	канспіратыўна	Adv
канструктыўна	канструктыўна	Adv
канстытуцыйна	канстытуцыйна	Adv
кантабіле	кантабіле	Adv
кантрасна	кантрасна	Adv
канфідэнцыяльна	канфідэнцыяльна	Adv
канфузліва	канфузліва	Adv
канцэнтрычна	канцэнтрычна	Adv
канцэптуальна	канцэптуальна	Adv
канчаткова	канчаткова	Adv
капельку	капельку	Adv
капітальна	капітальна	Adv
капрызна	капрызна	Adv
карава	карава	Adv
кардынальна	кардынальна	Adv
кароткачасова	кароткачасова	Adv
карпаратыўна	карпаратыўна	Adv
карпатліва	карпатліва	Adv
картава	картава	Adv
карцінна	карцінна	Adv
карыкатурна	карыкатурна	Adv
карысліва	карысліва	Adv
карысталюбіва	карысталюбіва	Adv
карысталюбна	карысталюбна	Adv
касабока	касабока	Adv
касалапа	касалапа	Adv
катаржна	катаржна	Adv
катастрафічна	катастрафічна	Adv
катэгарычна	катэгарычна	Adv
кашмарна	кашмарна	Adv
каштоўна	каштоўна	Adv
кашчунна	кашчунна	Adv
кваліфікавана	кваліфікавана	Adv
квапна	квапна	Adv
квола	квола	Adv
квяціста	квяціста	Adv
келейна	келейна	Adv
кемка	кемка	Adv
кемліва	кемліва	Adv
кемна	кемна	Adv
кепска	кепска	Adv
кіношна	кіношна	Adv
кіславата	кіславата	Adv
клапатліва	клапатліва	Adv
клапотна	клапотна	Adv
класава	класава	Adv
класічна	класічна	Adv
класна	класна	Adv
клінам	клінам	Adv
клінічна	клінічна	Adv
клыкаста	клыкаста	Adv
клятвенна	клятвенна	Adv
кніжна	кніжна	Adv
козытна	козытна	Adv
колка	колка	Adv
колькасна	колькасна	Adv
комплексна	комплексна	Adv
конна	конна	Adv
контурна	контурна	Adv
конусападобна	конусападобна	Adv
конча	конча	Adv
кораценька	кораценька	Adv
коса	коса	Adv
косна	косна	Adv
кпліва	кпліва	Adv
крадком	крадком	Adv
крадучыся	крадучыся	Adv
кранальна	кранальна	Adv
красамоўна	красамоўна	Adv
крокам	крокам	Adv
кропкава	кропкава	Adv
кроўна	кроўна	Adv
кругам	кругам	Adv
кругласутачна	кругласутачна	Adv
кругласуткава	кругласуткава	Adv
кругом	кругом	Adv
кружком	кружком	Adv
кружна	кружна	Adv
крукам	крукам	Adv
крывава	крывава	Adv
крывадушна	крывадушна	Adv
крыважэрна	крыважэрна	Adv
крыж-накрыж	крыж-накрыж	Adv
крыжам	крыжам	Adv
крыжападобна	крыжападобна	Adv
крыкліва	крыкліва	Adv
крымінальна	крымінальна	Adv
крытычна	крытычна	Adv
крыўдліва	крыўдліва	Adv
крыўдна	крыўдна	Adv
крыху	крыху	Adv
крышачку	крышачку	Adv
крышку	крышку	Adv
крышталічна	крышталічна	Adv
крыштальна	крыштальна	Adv
крэатыўна	крэатыўна	Adv
крэпка	крэпка	Adv
крэсава	крэсава	Adv
крэшчэнда	крэшчэнда	Adv
кулём	кулём	Adv
курна	курна	Adv
лабараторна	лабараторна	Adv
ладам	ладам	Adv
ладком	ладком	Adv
ладна	ладна	Adv
ладнавата	ладнавата	Adv
лакальна	лакальна	Adv
лапідарна	лапідарна	Adv
ласа	ласа	Adv
леваруч	леваруч	Adv
легальна	легальна	Adv
лёганька	лёганька	Adv
легата	легата	Adv
лёгенька	лёгенька	Adv
легкаважна	легкаважна	Adv
легкавата	легкавата	Adv
легкадумна	легкадумна	Adv
ледзь	ледзь	Adv
ледзь-ледзь	ледзь-ледзь	Adv
ледзьве	ледзьве	Adv
лежма	лежма	Adv
лексічна	лексічна	Adv
ленавата	ленавата	Adv
лепей	лепей	Adv
лепш	лепш	Adv
лёсавызначальна	лёсавызначальна	Adv
летам	летам	Adv
летась	летась	Adv
летуценна	летуценна	Adv
ліберальна	ліберальна	Adv
лінейна	лінейна	Adv
ліпка	ліпка	Adv
лісліва	лісліва	Adv
літаральна	літаральна	Adv
літаратурна	літаратурна	Adv
літасціва	літасціва	Adv
ліхаманкава	ліхаманкава	Adv
ліцэнзійна	ліцэнзійна	Adv
лішне	лішне	Adv
лунацічна	лунацічна	Adv
льга	льга	Adv
льготна	льготна	Adv
люба	люба	Adv
любоўна	любоўна	Adv
людна	людна	Adv
люта	люта	Adv
ляніва	ляніва	Adv
лятальна	лятальна	Adv
мабільна	мабільна	Adv
магічна	магічна	Adv
магнетычна	магнетычна	Adv
магчыма	магчыма	Adv
мадэрата	мадэрата	Adv
мажліва	мажліва	Adv
мажорна	мажорна	Adv
максімальна	максімальна	Adv
мала-памалу	мала-памалу	Adv
малаважна	малаважна	Adv
малавата	малавата	Adv
малаверагодна	малаверагодна	Adv
малавоблачна	малавоблачна	Adv
маладжава	маладжава	Adv
маладзіком	маладзіком	Adv
маладушна	маладушна	Adv
малазначна	малазначна	Adv
малаімаверна	малаімаверна	Adv
малаістотна	малаістотна	Adv
малайцавата	малайцавата	Adv
малалюдна	малалюдна	Adv
маланкава	маланкава	Adv
малапісьменна	малапісьменна	Adv
малінава	малінава	Adv
малітоўна	малітоўна	Adv
малочна	малочна	Adv
маляўніча	маляўніча	Adv
маналітна	маналітна	Adv
манапольна	манапольна	Adv
манатонна	манатонна	Adv
маніякальна	маніякальна	Adv
манументальна	манументальна	Adv
маральна	маральна	Adv
маркотна	маркотна	Adv
марна	марна	Adv
масава	масава	Adv
матэматычна	матэматычна	Adv
матэрыяльна	матэрыяльна	Adv
маўкліва	маўкліва	Adv
маўчком	маўчком	Adv
маштабна	маштабна	Adv
машынальна	машынальна	Adv
медна	медна	Adv
медыкаментозна	медыкаментозна	Adv
меладраматычна	меладраматычна	Adv
меладычна	меладычна	Adv
меланхалічна	меланхалічна	Adv
мелкавата	мелкавата	Adv
мелькам	мелькам	Adv
менавіта	менавіта	Adv
ментальна	ментальна	Adv
менш	менш	Adv
мерна	мерна	Adv
мёртва	мёртва	Adv
месяцамі	месяцамі	Adv
месячна	месячна	Adv
метадычна	метадычна	Adv
металёва	металёва	Adv
метафарычна	метафарычна	Adv
метафізічна	метафізічна	Adv
метка	метка	Adv
мехавата	мехавата	Adv
механістычна	механістычна	Adv
механічна	механічна	Adv
мешкавата	мешкавата	Adv
мігам	мігам	Adv
мігатліва	мігатліва	Adv
міжволі	міжволі	Adv
міжвольна	міжвольна	Adv
міжнародна	міжнародна	Adv
міласціва	міласціва	Adv
міласэрна	міласэрна	Adv
міма	міма	Adv
мімаволі	мімаволі	Adv
мімавольна	мімавольна	Adv
мімаездам	мімаездам	Adv
мімалётам	мімалётам	Adv
мімалётна	мімалётна	Adv
мімаходам	мімаходам	Adv
мімаходзь	мімаходзь	Adv
мімічна	мімічна	Adv
мінімальна	мінімальна	Adv
мініяцюрна	мініяцюрна	Adv
мінорна	мінорна	Adv
міралюбіва	міралюбіва	Adv
міралюбна	міралюбна	Adv
мірна	мірна	Adv
містычна	містычна	Adv
мітусліва	мітусліва	Adv
млосна	млосна	Adv
млява	млява	Adv
мнагавата	мнагавата	Adv
мнагазначна	мнагазначна	Adv
мнагакратна	мнагакратна	Adv
мнагалюдна	мнагалюдна	Adv
мнагаслоўна	мнагаслоўна	Adv
многа-многа	многа-многа	Adv
многаразова	многаразова	Adv
можна	можна	Adv
мокра	мокра	Adv
молем	молем	Adv
моташна	моташна	Adv
моўна	моўна	Adv
моўчкі	моўчкі	Adv
мройна	мройна	Adv
мсціва	мсціва	Adv
мудрагеліста	мудрагеліста	Adv
музычна	музычна	Adv
мулка	мулка	Adv
мысленна	мысленна	Adv
мэтазгодна	мэтазгодна	Adv
мэтанакіравана	мэтанакіравана	Adv
мядова	мядова	Adv
мяльком	мяльком	Adv
мярзотна	мярзотна	Adv
на-гара	на-гара	Adv
наабгон	наабгон	Adv
наадварот	наадварот	Adv
наадрэз	наадрэз	Adv
наапашкі	наапашкі	Adv
набак	набак	Adv
набакір	набакір	Adv
набасанож	набасанож	Adv
набожна	набожна	Adv
набок	набок	Adv
навакол	навакол	Adv
навалам	навалам	Adv
навек	навек	Adv
навекі	навекі	Adv
наверсе	наверсе	Adv
наверх	наверх	Adv
навечна	навечна	Adv
навідавоку	навідавоку	Adv
навобмацак	навобмацак	Adv
наводдалек	наводдалек	Adv
наводдаль	наводдаль	Adv
наводліў	наводліў	Adv
наводмаш	наводмаш	Adv
наводшыбе	наводшыбе	Adv
навокал	навокал	Adv
навокала	навокала	Adv
навочна	навочна	Adv
навукова	навукова	Adv
навынас	навынас	Adv
навыперадкі	навыперадкі	Adv
навыпуск	навыпуск	Adv
навыраст	навыраст	Adv
навырост	навырост	Adv
навыцяжку	навыцяжку	Adv
нагала	нагала	Adv
нагбом	нагбом	Adv
нагінкам	нагінкам	Adv
нагла	нагла	Adv
наглуха	наглуха	Adv
наглядна	наглядна	Adv
надакучліва	надакучліва	Adv
надалей	надалей	Adv
надаўжэй	надаўжэй	Adv
надвае	надвае	Adv
надвечар	надвечар	Adv
надвое	надвое	Adv
надвор	надвор	Adv
надвячоркам	надвячоркам	Adv
надгаладзь	надгаладзь	Adv
надзвычай	надзвычай	Adv
надзвычайна	надзвычайна	Adv
надзённа	надзённа	Adv
надзіва	надзіва	Adv
надмерна	надмерна	Adv
надоечы	надоечы	Adv
надоўга	надоўга	Adv
надрывіста	надрывіста	Adv
надрыўна	надрыўна	Adv
надта	надта	Adv
надумана	надумана	Adv
назад	назад	Adv
назаўтра	назаўтра	Adv
назло	назло	Adv
назнарок	назнарок	Adv
назойліва	назойліва	Adv
назубок	назубок	Adv
назусім	назусім	Adv
наіўна	наіўна	Adv
найболей	найболей	Adv
найлепей	найлепей	Adv
найперш	найперш	Adv
накасяк	накасяк	Adv
накатам	накатам	Adv
наколькі	наколькі	Adv
накрыж	накрыж	Adv
накрыжкі	накрыжкі	Adv
налапам	налапам	Adv
налева	налева	Adv
належна	належна	Adv
налета	налета	Adv
налётам	налётам	Adv
наліха	наліха	Adv
намацкам	намацкам	Adv
намёкам	намёкам	Adv
намертва	намертва	Adv
намёртва	намёртва	Adv
намінальна	намінальна	Adv
намнога	намнога	Adv
нанава	нанава	Adv
нанач	нанач	Adv
нанова	нанова	Adv
наносна	наносна	Adv
наноў	наноў	Adv
наогул	наогул	Adv
напавал	напавал	Adv
напавер	напавер	Adv
напаверх	напаверх	Adv
напагатове	напагатове	Adv
напагатоў	напагатоў	Adv
нападрост	нападрост	Adv
нападхват	нападхват	Adv
напаказ	напаказ	Adv
напал	напал	Adv
напалавіну	напалавіну	Adv
напалам	напалам	Adv
напалову	напалову	Adv
напапалам	напапалам	Adv
напаследак	напаследак	Adv
напаўафіцыйна	напаўафіцыйна	Adv
напаўголаса	напаўголаса	Adv
напаўдарозе	напаўдарозе	Adv
напаўжартаўліва	напаўжартаўліва	Adv
напаўлегальна	напаўлегальна	Adv
напаўпаваротна	напаўпаваротна	Adv
напаўсілы	напаўсілы	Adv
напаўсур'ёзна	напаўсур'ёзна	Adv
напачатку	напачатку	Adv
напашэве	напашэве	Adv
наперабой	наперабой	Adv
наперавес	наперавес	Adv
наперагонкі	наперагонкі	Adv
наперад	наперад	Adv
наперадзе	наперадзе	Adv
наперакор	наперакор	Adv
напералік	напералік	Adv
напераменку	напераменку	Adv
наперарэз	наперарэз	Adv
наперахват	наперахват	Adv
напеўна	напеўна	Adv
напоперак	напоперак	Adv
напорна	напорна	Adv
напорыста	напорыста	Adv
напоўніцу	напоўніцу	Adv
направа	направа	Adv
напрадвесні	напрадвесні	Adv
напракат	напракат	Adv
напралёт	напралёт	Adv
напралом	напралом	Adv
напрамкі	напрамкі	Adv
напрамую	напрамую	Adv
напрапалую	напрапалую	Adv
напрасткі	напрасткі	Adv
напрасцяк	напрасцяк	Adv
напраўду	напраўду	Adv
напрост	напрост	Adv
напроці	напроці	Adv
напружана	напружана	Adv
напрыканцы	напрыканцы	Adv
напышліва	напышліва	Adv
напэўна	напэўна	Adv
напярэдадні	напярэдадні	Adv
напярэймы	напярэймы	Adv
напярэсцігі	напярэсцігі	Adv
напярэхваткі	напярэхваткі	Adv
напята	напята	Adv
наравіста	наравіста	Adv
нараспашку	нараспашку	Adv
нараспеў	нараспеў	Adv
нарасхват	нарасхват	Adv
нараўне	нараўне	Adv
нармалёва	нармалёва	Adv
нармальна	нармальна	Adv
нарматыўна	нарматыўна	Adv
нарокам	нарокам	Adv
наросхліст	наросхліст	Adv
наросхрыст	наросхрыст	Adv
нароўні	нароўні	Adv
наруку	наруку	Adv
насамперш	насамперш	Adv
насамрэч	насамрэч	Adv
насілу	насілу	Adv
насільна	насільна	Adv
наскокам	наскокам	Adv
наскора	наскора	Adv
наскрозь	наскрозь	Adv
наслепа	наслепа	Adv
насмелую	насмелую	Adv
насмерць	насмерць	Adv
насмех	насмех	Adv
насмешліва	насмешліва	Adv
наспех	наспех	Adv
настойліва	настойліва	Adv
настолькі	настолькі	Adv
насторч	насторч	Adv
настрэчу	настрэчу	Adv
насуперак	насуперак	Adv
насупраць	насупраць	Adv
насур'ёз	насур'ёз	Adv
насустрач	насустрач	Adv
насуха	насуха	Adv
насцеж	насцеж	Adv
насцярожліва	насцярожліва	Adv
насыпам	насыпам	Adv
натарыяльна	натарыяльна	Adv
натоўпам	натоўпам	Adv
натрае	натрае	Adv
натужліва	натужліва	Adv
натужна	натужна	Adv
натуралістычна	натуралістычна	Adv
натуральна	натуральна	Adv
натхнёна	натхнёна	Adv
наўгад	наўгад	Adv
наўгалоп	наўгалоп	Adv
наўгрунь	наўгрунь	Adv
наўдалую	наўдалую	Adv
наўдачу	наўдачу	Adv
наўзамен	наўзамен	Adv
наўзахапкі	наўзахапкі	Adv
наўзахваткі	наўзахваткі	Adv
наўзбоч	наўзбоч	Adv
наўздагад	наўздагад	Adv
наўздагон	наўздагон	Adv
наўздагонкі	наўздагонкі	Adv
наўздзіў	наўздзіў	Adv
наўздоўж	наўздоўж	Adv
наўзрыд	наўзрыд	Adv
наўкол	наўкол	Adv
наўкола	наўкола	Adv
наўкос	наўкос	Adv
наўкруг	наўкруг	Adv
наўкруга	наўкруга	Adv
наўме	наўме	Adv
наўмысля	наўмысля	Adv
наўмысна	наўмысна	Adv
наўмысне	наўмысне	Adv
наўперад	наўперад	Adv
наўпрост	наўпрост	Adv
наўрад	наўрад	Adv
наўскасяк	наўскасяк	Adv
наўскач	наўскач	Adv
наўскід	наўскід	Adv
наўскідку	наўскідку	Adv
наўскос	наўскос	Adv
наўсцяж	наўсцяж	Adv
наўцекача	наўцекача	Adv
наўцёкі	наўцёкі	Adv
нахабна	нахабна	Adv
нахапкам	нахапкам	Adv
нахіла	нахіла	Adv
нахілена	нахілена	Adv
нахрапам	нахрапам	Adv
нахрапіста	нахрапіста	Adv
нацягнута	нацягнута	Adv
нацямку	нацямку	Adv
нацямочку	нацямочку	Adv
нацянькі	нацянькі	Adv
начарна	начарна	Adv
начорна	начорна	Adv
начыста	начыста	Adv
нашмат	нашмат	Adv
нашча	нашча	Adv
нашчэнт	нашчэнт	Adv
наяве	наяве	Adv
наяву	наяву	Adv
неабавязкова	неабавязкова	Adv
неабачліва	неабачліва	Adv
неабачна	неабачна	Adv
неабвержна	неабвержна	Adv
неабвяргальна	неабвяргальна	Adv
неабгрунтавана	неабгрунтавана	Adv
неабдумана	неабдумана	Adv
неабдымна	неабдымна	Adv
неабмежавана	неабмежавана	Adv
неабсяжна	неабсяжна	Adv
неабходна	неабходна	Adv
неабыякава	неабыякава	Adv
неаглядна	неаглядна	Adv
неад'емна	неад'емна	Adv
неадабральна	неадабральна	Adv
неадвольна	неадвольна	Adv
неадкладна	неадкладна	Adv
неадлучна	неадлучна	Adv
неадменна	неадменна	Adv
неадназначна	неадназначна	Adv
неаднаразова	неаднаразова	Adv
неаднойчы	неаднойчы	Adv
неаднолькава	неаднолькава	Adv
неадольна	неадольна	Adv
неадпаведна	неадпаведна	Adv
неадрыўна	неадрыўна	Adv
неадступна	неадступна	Adv
неадхільна	неадхільна	Adv
неадчувальна	неадчувальна	Adv
неадчэпна	неадчэпна	Adv
неадэкватна	неадэкватна	Adv
неазначальна	неазначальна	Adv
неакрэслена	неакрэслена	Adv
неактуальна	неактуальна	Adv
неактыўна	неактыўна	Adv
неакуратна	неакуратна	Adv
неаператыўна	неаператыўна	Adv
неапетытна	неапетытна	Adv
неапраўдана	неапраўдана	Adv
неарганізавана	неарганізавана	Adv
неардынарна	неардынарна	Adv
неасветлена	неасветлена	Adv
неаслабна	неаслабна	Adv
неаспрэчна	неаспрэчна	Adv
неасцярожна	неасцярожна	Adv
неаўтарытэтна	неаўтарытэтна	Adv
неафіцыйна	неафіцыйна	Adv
неахайна	неахайна	Adv
неахвотна	неахвотна	Adv
неацэнна	неацэнна	Adv
неашчадна	неашчадна	Adv
небагата	небагата	Adv
небезвынікова	небезвынікова	Adv
небездакорна	небездакорна	Adv
небеззаганна	небеззаганна	Adv
небезкарысліва	небезкарысліва	Adv
небескарысліва	небескарысліва	Adv
небескарысна	небескарысна	Adv
небеспадстаўна	небеспадстаўна	Adv
небеспаспяхова	небеспаспяхова	Adv
небесстаронна	небесстаронна	Adv
небывала	небывала	Adv
неваяўніча	неваяўніча	Adv
неверагодна	неверагодна	Adv
невідушча	невідушча	Adv
невінавата	невінавата	Adv
невыгодна	невыгодна	Adv
невыказна	невыказна	Adv
невыкараняльна	невыкараняльна	Adv
невылазна	невылазна	Adv
невылечна	невылечна	Adv
невымерна	невымерна	Adv
невымоўна	невымоўна	Adv
невыносна	невыносна	Adv
невыпадкова	невыпадкова	Adv
невыразна	невыразна	Adv
невысакародна	невысакародна	Adv
невысока	невысока	Adv
невытлумачальна	невытлумачальна	Adv
невядома	невядома	Adv
негадана	негадана	Adv
негарманічна	негарманічна	Adv
негасцінна	негасцінна	Adv
негатыўна	негатыўна	Adv
негігіенічна	негігіенічна	Adv
неглыбока	неглыбока	Adv
неграцыёзна	неграцыёзна	Adv
негрунтоўна	негрунтоўна	Adv
негуманна	негуманна	Adv
недабратворна	недабратворна	Adv
недабраякасна	недабраякасна	Adv
недаверліва	недаверліва	Adv
недазволена	недазволена	Adv
недакладна	недакладна	Adv
недалёка	недалёка	Adv
недалёчка	недалёчка	Adv
недалікатна	недалікатна	Adv
недальнабачна	недальнабачна	Adv
недапушчальна	недапушчальна	Adv
недаравальна	недаравальна	Adv
недарма	недарма	Adv
недарэмна	недарэмна	Adv
недарэчна	недарэчна	Adv
недарэчы	недарэчы	Adv
недасканала	недасканала	Adv
недастаткова	недастаткова	Adv
недаступна	недаступна	Adv
недасягальна	недасягальна	Adv
недасяжна	недасяжна	Adv
недатыкальна	недатыкальна	Adv
недаўгавечна	недаўгавечна	Adv
недаўгачасна	недаўгачасна	Adv
недаўменна	недаўменна	Adv
недвухсэнсава	недвухсэнсава	Adv
недвухсэнсоўна	недвухсэнсоўна	Adv
недружалюбна	недружалюбна	Adv
недыпламатычна	недыпламатычна	Adv
недысцыплінавана	недысцыплінавана	Adv
недэмакратычна	недэмакратычна	Adv
нежыватворна	нежыватворна	Adv
нежыццёва	нежыццёва	Adv
незабыўна	незабыўна	Adv
незадаволена	незадаволена	Adv
незадоўга	незадоўга	Adv
незайздросна	незайздросна	Adv
незаканамерна	незаканамерна	Adv
незаконна	незаконна	Adv
незалежна	незалежна	Adv
незаменна	незаменна	Adv
незаметна	незаметна	Adv
незаможна	незаможна	Adv
незамыславата	незамыславата	Adv
незаслужана	незаслужана	Adv
незаўважна	незаўважна	Adv
незацікаўлена	незацікаўлена	Adv
незваротна	незваротна	Adv
незвычайна	незвычайна	Adv
незгаворліва	незгаворліва	Adv
незгасальна	незгасальна	Adv
нездавальняюча	нездавальняюча	Adv
нездаволена	нездаволена	Adv
нездарма	нездарма	Adv
нездарова	нездарова	Adv
незласліва	незласліва	Adv
незлічона	незлічона	Adv
незмаўкальна	незмаўкальна	Adv
незнаёма	незнаёма	Adv
незнарок	незнарок	Adv
незразумела	незразумела	Adv
незычліва	незычліва	Adv
неістотна	неістотна	Adv
неймаверна	неймаверна	Adv
нейтральна	нейтральна	Adv
некампетэнтна	некампетэнтна	Adv
некамплектна	некамплектна	Adv
неканкрэтна	неканкрэтна	Adv
неканчаткова	неканчаткова	Adv
некарысліва	некарысліва	Adv
некарэктна	некарэктна	Adv
некрытычна	некрытычна	Adv
некультурна	некультурна	Adv
нелагічна	нелагічна	Adv
неласкава	неласкава	Adv
нелегальна	нелегальна	Adv
нелітасціва	нелітасціва	Adv
нельга	нельга	Adv
нема	нема	Adv
немаведама	немаведама	Adv
немагчыма	немагчыма	Adv
немажліва	немажліва	Adv
немігаючы	немігаючы	Adv
немілагучна	немілагучна	Adv
неміласэрна	неміласэрна	Adv
немінуча	немінуча	Adv
немітусліва	немітусліва	Adv
немнагалюдна	немнагалюдна	Adv
немнагаслоўна	немнагаслоўна	Adv
немудрагеліста	немудрагеліста	Adv
немэтазгодна	немэтазгодна	Adv
ненавукова	ненавукова	Adv
ненадзейна	ненадзейна	Adv
ненадоўга	ненадоўга	Adv
неназнарок	неназнарок	Adv
неналежна	неналежна	Adv
ненамнога	ненамнога	Adv
ненармальна	ненармальна	Adv
ненасытна	ненасытна	Adv
ненатуральна	ненатуральна	Adv
ненаўмысля	ненаўмысля	Adv
ненаўмысна	ненаўмысна	Adv
непаважліва	непаважліва	Adv
непаваротліва	непаваротліва	Adv
непадалёк	непадалёк	Adv
непадалёку	непадалёку	Adv
непадзельна	непадзельна	Adv
непадкупна	непадкупна	Adv
непадобна	непадобна	Adv
непадступна	непадступна	Adv
непажадана	непажадана	Adv
непазбежна	непазбежна	Adv
непазнавальна	непазнавальна	Adv
непакорліва	непакорліва	Adv
непакорна	непакорна	Adv
непамерна	непамерна	Adv
непамысна	непамысна	Adv
непанадна	непанадна	Adv
непапраўна	непапраўна	Adv
непапулярна	непапулярна	Adv
непараўнальна	непараўнальна	Adv
непараўнана	непараўнана	Adv
непарушальна	непарушальна	Adv
непарушна	непарушна	Adv
непарыўна	непарыўна	Adv
непаседліва	непаседліва	Adv
непаслухмяна	непаслухмяна	Adv
непаслядоўна	непаслядоўна	Adv
непаспяхова	непаспяхова	Adv
непасрэдна	непасрэдна	Adv
непатрабавальна	непатрабавальна	Adv
непатрэбна	непатрэбна	Adv
непаўнапраўна	непаўнапраўна	Adv
непаўнацэнна	непаўнацэнна	Adv
непаўторна	непаўторна	Adv
непахвальна	непахвальна	Adv
непахісна	непахісна	Adv
непачціва	непачціва	Adv
непашкоджана	непашкоджана	Adv
непедагагічна	непедагагічна	Adv
непераадольна	непераадольна	Adv
непераканальна	непераканальна	Adv
непераканаўча	непераканаўча	Adv
непераможна	непераможна	Adv
неперспектыўна	неперспектыўна	Adv
непісьменна	непісьменна	Adv
непланамерна	непланамерна	Adv
непрабудна	непрабудна	Adv
неправамерна	неправамерна	Adv
неправамоцна	неправамоцна	Adv
непраглядна	непраглядна	Adv
непрадбачана	непрадбачана	Adv
непрадказальна	непрадказальна	Adv
непрадузята	непрадузята	Adv
непрадуктыўна	непрадуктыўна	Adv
непрадукцыйна	непрадукцыйна	Adv
непрадумана	непрадумана	Adv
непразорліва	непразорліва	Adv
непразрыста	непразрыста	Adv
непрактычна	непрактычна	Adv
непрапарцыянальна	непрапарцыянальна	Adv
непраўдападобна	непраўдападобна	Adv
непраўдзіва	непраўдзіва	Adv
непрафесійна	непрафесійна	Adv
непрафесіянальна	непрафесіянальна	Adv
непрывабна	непрывабна	Adv
непрыветліва	непрыветліва	Adv
непрыветна	непрыветна	Adv
непрывычна	непрывычна	Adv
непрыглядна	непрыглядна	Adv
непрыгожа	непрыгожа	Adv
непрыемна	непрыемна	Adv
непрыкаяна	непрыкаяна	Adv
непрымірыма	непрымірыма	Adv
непрынцыпова	непрынцыпова	Adv
непрыстойна	непрыстойна	Adv
непрыступна	непрыступна	Adv
непрытворна	непрытворна	Adv
непрытоена	непрытоена	Adv
непрытомна	непрытомна	Adv
непрытульна	непрытульна	Adv
непрыхавана	непрыхавана	Adv
непрыхільна	непрыхільна	Adv
непрыцэльна	непрыцэльна	Adv
непрыязна	непрыязна	Adv
неразборліва	неразборліва	Adv
неразважліва	неразважліва	Adv
неразважна	неразважна	Adv
нераздзельна	нераздзельна	Adv
неразлучна	неразлучна	Adv
неразрыўна	неразрыўна	Adv
неразумна	неразумна	Adv
нераўнадушна	нераўнадушна	Adv
нераўнамерна	нераўнамерна	Adv
нерацыянальна	нерацыянальна	Adv
нерашуча	нерашуча	Adv
нервова	нервова	Adv
нервозна	нервозна	Adv
нерупліва	нерупліва	Adv
нерухава	нерухава	Adv
нерухліва	нерухліва	Adv
нерухома	нерухома	Adv
нерэальна	нерэальна	Adv
нерэгулярна	нерэгулярна	Adv
нерэнтабельна	нерэнтабельна	Adv
несакрушальна	несакрушальна	Adv
несалідна	несалідна	Adv
несамавіта	несамавіта	Adv
несамастойна	несамастойна	Adv
несамахоць	несамахоць	Adv
несардэчна	несардэчна	Adv
несвабодна	несвабодна	Adv
несвоечасова	несвоечасова	Adv
несвядома	несвядома	Adv
несіметрычна	несіметрычна	Adv
несімпатычна	несімпатычна	Adv
несканчона	несканчона	Adv
нескладана	нескладана	Adv
неспагадліва	неспагадліва	Adv
неспагадна	неспагадна	Adv
неспадзеўкі	неспадзеўкі	Adv
неспадзеўна	неспадзеўна	Adv
неспадзявана	неспадзявана	Adv
неспазнана	неспазнана	Adv
неспакойна	неспакойна	Adv
неспасцігальна	неспасцігальна	Adv
неспатольна	неспатольна	Adv
неспрыяльна	неспрыяльна	Adv
нестабільна	нестабільна	Adv
нестандартна	нестандартна	Adv
несувымерна	несувымерна	Adv
несуладна	несуладна	Adv
несумленна	несумленна	Adv
несумненна	несумненна	Adv
несумнеўна	несумнеўна	Adv
несупынна	несупынна	Adv
несур'ёзна	несур'ёзна	Adv
несуразмерна	несуразмерна	Adv
несуцешна	несуцешна	Adv
несуцішна	несуцішна	Adv
несучасна	несучасна	Adv
несціхана	несціхана	Adv
нета	нета	Adv
нетактоўна	нетактоўна	Adv
нетактычна	нетактычна	Adv
нетаропка	нетаропка	Adv
нетрадыцыйна	нетрадыцыйна	Adv
нетрывала	нетрывала	Adv
неўзабаве	неўзабаве	Adv
неўзаметку	неўзаметку	Adv
неўласціва	неўласціва	Adv
неўпапад	неўпапад	Adv
неўправарот	неўправарот	Adv
неўпрыкмет	неўпрыкмет	Adv
неўпрыцям	неўпрыцям	Adv
неўразумела	неўразумела	Adv
неўраўнаважана	неўраўнаважана	Adv
неўсвядомлена	неўсвядомлена	Adv
неўспадзеўкі	неўспадзеўкі	Adv
неўтаймавана	неўтаймавана	Adv
неўтаймоўна	неўтаймоўна	Adv
нефармальна	нефармальна	Adv
нехаця	нехаця	Adv
нехлямяжа	нехлямяжа	Adv
нецвяроза	нецвяроза	Adv
нецікава	нецікава	Adv
нецэнзурна	нецэнзурна	Adv
нецярпіма	нецярпіма	Adv
нецярпліва	нецярпліва	Adv
нечакана	нечакана	Adv
нечалавечна	нечалавечна	Adv
нечленараздзельна	нечленараздзельна	Adv
нечувана	нечувана	Adv
нечулліва	нечулліва	Adv
нечытабельна	нечытабельна	Adv
нечытэльна	нечытэльна	Adv
нешматлюдна	нешматлюдна	Adv
нешматслоўна	нешматслоўна	Adv
нешчасліва	нешчасліва	Adv
неэканомна	неэканомна	Adv
неэлегантна	неэлегантна	Adv
неэфектыўна	неэфектыўна	Adv
ніжай	ніжай	Adv
нізам	нізам	Adv
нізвання	нізвання	Adv
нізенечка	нізенечка	Adv
нізкавата	нізкавата	Adv
нізкапробна	нізкапробна	Adv
ніц	ніц	Adv
ніцам	ніцам	Adv
ніцма	ніцма	Adv
нішкам	нішкам	Adv
нова	нова	Adv
ноччу	ноччу	Adv
нудліва	нудліва	Adv
нуднавата	нуднавата	Adv
нэрвова	нэрвова	Adv
нябачна	нябачна	Adv
нябедна	нябедна	Adv
няблага	няблага	Adv
нябойка	нябойка	Adv
няважна	няважна	Adv
няварта	няварта	Adv
нявесела	нявесела	Adv
няветла	няветла	Adv
няветліва	няветліва	Adv
нявінна	нявінна	Adv
нявольна	нявольна	Adv
няволяй	няволяй	Adv
нявыгадна	нявыгадна	Adv
нявыспана	нявыспана	Adv
нявытрымана	нявытрымана	Adv
нягегла	нягегла	Adv
нягібка	нягібка	Adv
нягладка	нягладка	Adv
нягнутка	нягнутка	Adv
нягожа	нягожа	Adv
няголасна	няголасна	Adv
нягуста	нягуста	Adv
нягучна	нягучна	Adv
нядаўна	нядаўна	Adv
нядбайна	нядбайна	Adv
нядбала	нядбала	Adv
нядзейна	нядзейна	Adv
нядзіўна	нядзіўна	Adv
нядобра	нядобра	Adv
нядобразычліва	нядобразычліва	Adv
нядобрапрыстойна	нядобрапрыстойна	Adv
нядобрасумленна	нядобрасумленна	Adv
нядорага	нядорага	Adv
нядосыць	нядосыць	Adv
нядоўга	нядоўга	Adv
нядружна	нядружна	Adv
нядрэнна	нядрэнна	Adv
нядужа	нядужа	Adv
няёмка	няёмка	Adv
нязвыкла	нязвыкла	Adv
нязвычна	нязвычна	Adv
нязвязна	нязвязна	Adv
нязгасна	нязгасна	Adv
нязграбна	нязграбна	Adv
няздорава	няздорава	Adv
нязладжана	нязладжана	Adv
нязломна	нязломна	Adv
нязлосна	нязлосна	Adv
нязменна	нязменна	Adv
нязмерна	нязмерна	Adv
нязмоўчна	нязмоўчна	Adv
нязмушана	нязмушана	Adv
нязначна	нязначна	Adv
нязносна	нязносна	Adv
нязручна	нязручна	Adv
няйнакш	няйнакш	Adv
няйначай	няйначай	Adv
някепска	някепска	Adv
някомплексна	някомплексна	Adv
няладна	няладна	Adv
няласкава	няласкава	Adv
нялёгка	нялёгка	Adv
нялітасціва	нялітасціва	Adv
нялішне	нялішне	Adv
нялоўка	нялоўка	Adv
нялюба	нялюба	Adv
нялюдска	нялюдска	Adv
нямала	нямала	Adv
нямарна	нямарна	Adv
нямерана	нямерана	Adv
няміла	няміла	Adv
няміласліва	няміласліва	Adv
няміласціва	няміласціва	Adv
нямнога	нямнога	Adv
няможна	няможна	Adv
нямоцна	нямоцна	Adv
няплённа	няплённа	Adv
няпоўна	няпоўна	Adv
няпоўнасцю	няпоўнасцю	Adv
няправільна	няправільна	Adv
няпроста	няпроста	Adv
няпрошана	няпрошана	Adv
няпэўна	няпэўна	Adv
нярадасна	нярадасна	Adv
нярана	нярана	Adv
нярвова	нярвова	Adv
няроўна	няроўна	Adv
нярэдка	нярэдка	Adv
няскладна	няскладна	Adv
няскромна	няскромна	Adv
няслушна	няслушна	Adv
нясмачна	нясмачна	Adv
нясмела	нясмела	Adv
няспешна	няспешна	Adv
няспорна	няспорна	Adv
няспраўна	няспраўна	Adv
няспрытна	няспрытна	Adv
няспынна	няспынна	Adv
нястала	нястала	Adv
нястомна	нястомна	Adv
нястрога	нястрога	Adv
нястройна	нястройна	Adv
нястрымана	нястрымана	Adv
нястрымна	нястрымна	Adv
нясцерпна	нясцерпна	Adv
нясціпла	нясціпла	Adv
нятанна	нятанна	Adv
нятрапна	нятрапна	Adv
няўважліва	няўважліва	Adv
няўважна	няўважна	Adv
няўдала	няўдала	Adv
няўдачна	няўдачна	Adv
няўдзячна	няўдзячна	Adv
няўзнак	няўзнак	Adv
няўклюдна	няўклюдна	Adv
няўлад	няўлад	Adv
няўлоўна	няўлоўна	Adv
няўмела	няўмела	Adv
няўмеру	няўмеру	Adv
няўмольна	няўмольна	Adv
няўмысля	няўмысля	Adv
няўпынна	няўпынна	Adv
няўпэўнена	няўпэўнена	Adv
няўрокам	няўрокам	Adv
няўрымсліва	няўрымсліва	Adv
няўстойліва	няўстойліва	Adv
няўтольна	няўтольна	Adv
няўтомна	няўтомна	Adv
няўтратна	няўтратна	Adv
няўтульна	няўтульна	Adv
няўхільна	няўхільна	Adv
няўцешліва	няўцешліва	Adv
няўцешна	няўцешна	Adv
няўцям	няўцям	Adv
няўцямліва	няўцямліва	Adv
няўцямна	няўцямна	Adv
няўчас	няўчас	Adv
няўчасна	няўчасна	Adv
няўяўна	няўяўна	Adv
няхітра	няхітра	Adv
няцвёрда	няцвёрда	Adv
няцяжка	няцяжка	Adv
нячаста	нячаста	Adv
нячула	нячула	Adv
нячутна	нячутна	Adv
нячыста	нячыста	Adv
няшкодна	няшкодна	Adv
няшмат	няшмат	Adv
няшчадна	няшчадна	Adv
няшчыльна	няшчыльна	Adv
няшчыра	няшчыра	Adv
няякасна	няякасна	Adv
няяўна	няяўна	Adv
оптам	оптам	Adv
п'яна	п'яна	Adv
п'янавата	п'янавата	Adv
па-абхазску	па-абхазску	Adv
па-агіднаму	па-агіднаму	Adv
па-аджарску	па-аджарску	Adv
па-адыгейску	па-адыгейску	Adv
па-адэску	па-адэску	Adv
па-азербайджанску	па-азербайджанску	Adv
па-азіяцку	па-азіяцку	Adv
па-айчыннаму	па-айчыннаму	Adv
па-акцёрску	па-акцёрску	Adv
па-албанску	па-албанску	Adv
па-амерыканску	па-амерыканску	Adv
па-ангельску	па-ангельску	Adv
па-англійску	па-англійску	Adv
па-апостальскаму	па-апостальскаму	Adv
па-апякунску	па-апякунску	Adv
па-арабску	па-арабску	Adv
па-арлінаму	па-арлінаму	Adv
па-армейску	па-армейску	Adv
па-армянску	па-армянску	Adv
па-асабліваму	па-асабліваму	Adv
па-асенняму	па-асенняму	Adv
па-асецінску	па-асецінску	Adv
па-аўстралійску	па-аўстралійску	Adv
па-аўстрыйску	па-аўстрыйску	Adv
па-афіцэрску	па-афіцэрску	Adv
па-афрыканску	па-афрыканску	Adv
па-бабску	па-бабску	Adv
па-байранаўску	па-байранаўску	Adv
па-баксёрску	па-баксёрску	Adv
па-балацюкоўску	па-балацюкоўску	Adv
па-балгарску	па-балгарску	Adv
па-балонску	па-балонску	Adv
па-бальнічнаму	па-бальнічнаму	Adv
па-бальшавіцку	па-бальшавіцку	Adv
па-бандыцку	па-бандыцку	Adv
па-бацькоўску	па-бацькоўску	Adv
па-башкірску	па-башкірску	Adv
па-баявому	па-баявому	Adv
па-беламу	па-беламу	Adv
па-беларусінску	па-беларусінску	Adv
па-беларуску	па-беларуску	Adv
па-бельгійску	па-бельгійску	Adv
па-бенгальску	па-бенгальску	Adv
па-біблейску	па-біблейску	Adv
па-бірманску	па-бірманску	Adv
па-благому	па-благому	Adv
па-блазенску	па-блазенску	Adv
па-блюзнерску	па-блюзнерску	Adv
па-божаму	па-божаму	Adv
па-божаску	па-божаску	Adv
па-боску	па-боску	Adv
па-бразільску	па-бразільску	Adv
па-братняму	па-братняму	Adv
па-братэрску	па-братэрску	Adv
па-брацку	па-брацку	Adv
па-брэжнеўску	па-брэжнеўску	Adv
па-брэйгелеўску	па-брэйгелеўску	Adv
па-будзённаму	па-будзённаму	Adv
па-буйному	па-буйному	Adv
па-бурацку	па-бурацку	Adv
па-буржуйску	па-буржуйску	Adv
па-бутафорску	па-бутафорску	Adv
па-быкаўску	па-быкаўску	Adv
па-былому	па-былому	Adv
па-бычынаму	па-бычынаму	Adv
па-в'етнамску	па-в'етнамску	Adv
па-ваеннаму	па-ваеннаму	Adv
па-вайсковаму	па-вайсковаму	Adv
па-вар'яцку	па-вар'яцку	Adv
па-варварску	па-варварску	Adv
па-ваўчынаму	па-ваўчынаму	Adv
па-вегетарыянску	па-вегетарыянску	Adv
па-венгерску	па-венгерску	Adv
па-венесуэльску	па-венесуэльску	Adv
па-венецыянску	па-венецыянску	Adv
па-вераб'інаму	па-вераб'інаму	Adv
па-веснавому	па-веснавому	Adv
па-волатаўску	па-волатаўску	Adv
па-восеньску	па-восеньску	Adv
па-воўчаму	па-воўчаму	Adv
па-воўчы	па-воўчы	Adv
па-вужачаму	па-вужачаму	Adv
па-вужачы	па-вужачы	Adv
па-вужынаму	па-вужынаму	Adv
па-вулічнаму	па-вулічнаму	Adv
па-вучнёўску	па-вучнёўску	Adv
па-вушацку	па-вушацку	Adv
па-вялікаму	па-вялікаму	Adv
па-вялюгінску	па-вялюгінску	Adv
па-вясельнаму	па-вясельнаму	Adv
па-вясенняму	па-вясенняму	Adv
па-вясковаму	па-вясковаму	Adv
па-вясноваму	па-вясноваму	Adv
па-вячэрняму	па-вячэрняму	Adv
па-габрэйску	па-габрэйску	Adv
па-газетнаму	па-газетнаму	Adv
па-галівудску	па-галівудску	Adv
па-гарадзецку	па-гарадзецку	Adv
па-гарадскому	па-гарадскому	Adv
па-гаспадарску	па-гаспадарску	Adv
па-геройску	па-геройску	Adv
па-гіганцку	па-гіганцку	Adv
па-гомельску	па-гомельску	Adv
па-грамадзянску	па-грамадзянску	Adv
па-гродзенску	па-гродзенску	Adv
па-грубіянску	па-грубіянску	Adv
па-грузінску	па-грузінску	Adv
па-грэцку	па-грэцку	Adv
па-грэчаску	па-грэчаску	Adv
па-гусарску	па-гусарску	Adv
па-гусінаму	па-гусінаму	Adv
па-гэльску	па-гэльску	Adv
па-д'ябальску	па-д'ябальску	Adv
па-дамашняму	па-дамашняму	Adv
па-даросламу	па-даросламу	Adv
па-дастоеўску	па-дастоеўску	Adv
па-даўнейшаму	па-даўнейшаму	Adv
па-дацку	па-дацку	Adv
па-двурушніцку	па-двурушніцку	Adv
па-дзедаўску	па-дзедаўску	Adv
па-дзелавому	па-дзелавому	Adv
па-дзіцячаму	па-дзіцячаму	Adv
па-дзіцячы	па-дзіцячы	Adv
па-дзіцячым	па-дзіцячым	Adv
па-дзявоцку	па-дзявоцку	Adv
па-дзявочаму	па-дзявочаму	Adv
па-дзявочы	па-дзявочы	Adv
па-дзяржаўнаму	па-дзяржаўнаму	Adv
па-дзяцінаму	па-дзяцінаму	Adv
па-добраму	па-добраму	Adv
па-драпежніцку	па-драпежніцку	Adv
па-дробнаму	па-дробнаму	Adv
па-другому	па-другому	Adv
па-дурному	па-дурному	Adv
па-дылетанцку	па-дылетанцку	Adv
па-дыскатэчнаму	па-дыскатэчнаму	Adv
па-дэкаданцку	па-дэкаданцку	Adv
па-егіпецку	па-егіпецку	Adv
па-езуіцку	па-езуіцку	Adv
па-еўрапейску	па-еўрапейску	Adv
па-жабрацку	па-жабрацку	Adv
па-жабрачаму	па-жабрачаму	Adv
па-жаноцку	па-жаноцку	Adv
па-жаночаму	па-жаночаму	Adv
па-жаночы	па-жаночы	Adv
па-жывёльнаму	па-жывёльнаму	Adv
па-жывому	па-жывому	Adv
па-заканадаўчаму	па-заканадаўчаму	Adv
па-заліхвацку	па-заліхвацку	Adv
па-замежнаму	па-замежнаму	Adv
па-заўсёднаму	па-заўсёднаму	Adv
па-заходняму	па-заходняму	Adv
па-зверску	па-зверску	Adv
па-звярынаму	па-звярынаму	Adv
па-згодніцку	па-згодніцку	Adv
па-здрадніцку	па-здрадніцку	Adv
па-зімняму	па-зімняму	Adv
па-зімоваму	па-зімоваму	Adv
па-зладзейску	па-зладзейску	Adv
па-злосніцку	па-злосніцку	Adv
па-змоўніцку	па-змоўніцку	Adv
па-змяінаму	па-змяінаму	Adv
па-зязюльчынаму	па-зязюльчынаму	Adv
па-зямляцку	па-зямляцку	Adv
па-ідыёцку	па-ідыёцку	Adv
па-імперску	па-імперску	Adv
па-імпрэсіянісцку	па-імпрэсіянісцку	Adv
па-інданезійску	па-інданезійску	Adv
па-індыйску	па-індыйску	Adv
па-інтэлігентнаму	па-інтэлігентнаму	Adv
па-іншамоўнаму	па-іншамоўнаму	Adv
па-іракску	па-іракску	Adv
па-іранску	па-іранску	Adv
па-ірландску	па-ірландску	Adv
па-ісландску	па-ісландску	Adv
па-іспанску	па-іспанску	Adv
па-італьянску	па-італьянску	Adv
па-іўдзейску	па-іўдзейску	Adv
па-кавалерыйску	па-кавалерыйску	Adv
па-казахску	па-казахску	Adv
па-казацку	па-казацку	Adv
па-казачаму	па-казачаму	Adv
па-казённаму	па-казённаму	Adv
па-казлінаму	па-казлінаму	Adv
па-калмыцку	па-калмыцку	Adv
па-каляндарнаму	па-каляндарнаму	Adv
па-камандзірску	па-камандзірску	Adv
па-кампанейску	па-кампанейску	Adv
па-камсамольску	па-камсамольску	Adv
па-камуністычнаму	па-камуністычнаму	Adv
па-караткевічаўску	па-караткевічаўску	Adv
па-карэйску	па-карэйску	Adv
па-карэктарску	па-карэктарску	Adv
па-карэльску	па-карэльску	Adv
па-каталіцку	па-каталіцку	Adv
па-кацінаму	па-кацінаму	Adv
па-кашчэеўску	па-кашчэеўску	Adv
па-кашэчаму	па-кашэчаму	Adv
па-кашэчы	па-кашэчы	Adv
па-кіеўску	па-кіеўску	Adv
па-кіношнаму	па-кіношнаму	Adv
па-кітайску	па-кітайску	Adv
па-кіяскёрску	па-кіяскёрску	Adv
па-кніжнаму	па-кніжнаму	Adv
па-княску	па-княску	Adv
па-колішняму	па-колішняму	Adv
па-конску	па-конску	Adv
па-крутому	па-крутому	Adv
па-круцельску	па-круцельску	Adv
па-кулацку	па-кулацку	Adv
па-культурнаму	па-культурнаму	Adv
па-купалаўску	па-купалаўску	Adv
па-купецку	па-купецку	Adv
па-кыргызску	па-кыргызску	Adv
па-латыні	па-латыні	Adv
па-латышску	па-латышску	Adv
па-лацінску	па-лацінску	Adv
па-лёгкаму	па-лёгкаму	Adv
па-ленінску	па-ленінску	Adv
па-летняму	па-летняму	Adv
па-літоўску	па-літоўску	Adv
па-ліхадзейску	па-ліхадзейску	Adv
па-львінаму	па-львінаму	Adv
па-любому	па-любому	Adv
па-людску	па-людску	Adv
па-магілёўску	па-магілёўску	Adv
па-магнацку	па-магнацку	Adv
па-мазахісцку	па-мазахісцку	Adv
па-майску	па-майску	Adv
па-майстэрску	па-майстэрску	Adv
па-македонску	па-македонску	Adv
па-максімуму	па-максімуму	Adv
па-маладзецку	па-маладзецку	Adv
па-маладому	па-маладому	Adv
па-малдаўску	па-малдаўску	Adv
па-маленькаму	па-маленькаму	Adv
па-мамінаму	па-мамінаму	Adv
па-мангольску	па-мангольску	Adv
па-мардоўску	па-мардоўску	Adv
па-марксісцку	па-марксісцку	Adv
па-марсіянску	па-марсіянску	Adv
па-марыйску	па-марыйску	Adv
па-маскоўску	па-маскоўску	Adv
па-мастакоўску	па-мастакоўску	Adv
па-мастацку	па-мастацку	Adv
па-маўзонаўску	па-маўзонаўску	Adv
па-махлярску	па-махлярску	Adv
па-мацярынску	па-мацярынску	Adv
па-міліцэйску	па-міліцэйску	Adv
па-моднаму	па-моднаму	Adv
па-мотальску	па-мотальску	Adv
па-мужчынску	па-мужчынску	Adv
па-мужыцку	па-мужыцку	Adv
па-мышынаму	па-мышынаму	Adv
па-мядзведжаму	па-мядзведжаму	Adv
па-мядзведжы	па-мядзведжы	Adv
па-мясцоваму	па-мясцоваму	Adv
па-мяшчанску	па-мяшчанску	Adv
па-навуковаму	па-навуковаму	Adv
па-належнаму	па-належнаму	Adv
па-нарвежску	па-нарвежску	Adv
па-нармальнаму	па-нармальнаму	Adv
па-народнаму	па-народнаму	Adv
па-настаўніцку	па-настаўніцку	Adv
па-ненецку	па-ненецку	Adv
па-новаму	па-новаму	Adv
па-нявольніцку	па-нявольніцку	Adv
па-нямецку	па-нямецку	Adv
па-пакутніцку	па-пакутніцку	Adv
па-палянску	па-палянску	Adv
па-паляўнічаму	па-паляўнічаму	Adv
па-паляшуцку	па-паляшуцку	Adv
па-панібрацку	па-панібрацку	Adv
па-панску	па-панску	Adv
па-партугальску	па-партугальску	Adv
па-партызанску	па-партызанску	Adv
па-партыйнаму	па-партыйнаму	Adv
па-пастарнакаўску	па-пастарнакаўску	Adv
па-паходнаму	па-паходнаму	Adv
па-першабытнаму	па-першабытнаму	Adv
па-піцерску	па-піцерску	Adv
па-піянерску	па-піянерску	Adv
па-пластунску	па-пластунску	Adv
па-польску	па-польску	Adv
па-правінцыйнаму	па-правінцыйнаму	Adv
па-прадажніцку	па-прадажніцку	Adv
па-пралетарску	па-пралетарску	Adv
па-прамоўніцку	па-прамоўніцку	Adv
па-прарочы	па-прарочы	Adv
па-прастому	па-прастому	Adv
па-прасцецку	па-прасцецку	Adv
па-прасцяцку	па-прасцяцку	Adv
па-праўдзіваму	па-праўдзіваму	Adv
па-прафесарску	па-прафесарску	Adv
па-простаму	па-простаму	Adv
па-прускаўску	па-прускаўску	Adv
па-прыродцэнтрысцку	па-прыродцэнтрысцку	Adv
па-прыяцельску	па-прыяцельску	Adv
па-пталамееўску	па-пталамееўску	Adv
па-птушынаму	па-птушынаму	Adv
па-пушкінску	па-пушкінску	Adv
па-рабску	па-рабску	Adv
па-радзівілаўску	па-радзівілаўску	Adv
па-разбойніцку	па-разбойніцку	Adv
па-рамантычнаму	па-рамантычнаму	Adv
па-ранейшаму	па-ранейшаму	Adv
па-ранішняму	па-ранішняму	Adv
па-расейску	па-расейску	Adv
па-расійску	па-расійску	Adv
па-рознаму	па-рознаму	Adv
па-ружанску	па-ружанску	Adv
па-румынску	па-румынску	Adv
па-руску	па-руску	Adv
па-рыбінаму	па-рыбінаму	Adv
па-рыначнаму	па-рыначнаму	Adv
па-рыцарску	па-рыцарску	Adv
па-рэвалюцыйнаму	па-рэвалюцыйнаму	Adv
па-рэжысёрску	па-рэжысёрску	Adv
па-сабачаму	па-сабачаму	Adv
па-сабачы	па-сабачы	Adv
па-савецку	па-савецку	Adv
па-садысцку	па-садысцку	Adv
па-салаўінаму	па-салаўінаму	Adv
па-салдацку	па-салдацку	Adv
па-сапраўднаму	па-сапраўднаму	Adv
па-сацыялістычнаму	па-сацыялістычнаму	Adv
па-сваяцку	па-сваяцку	Adv
па-светламу	па-светламу	Adv
па-свецку	па-свецку	Adv
па-свінску	па-свінску	Adv
па-свойску	па-свойску	Adv
па-святочнаму	па-святочнаму	Adv
па-сельску	па-сельску	Adv
па-сённяшняму	па-сённяшняму	Adv
па-сербахарвацку	па-сербахарвацку	Adv
па-сербску	па-сербску	Adv
па-сібірску	па-сібірску	Adv
па-сіроцку	па-сіроцку	Adv
па-сірочы	па-сірочы	Adv
па-славацку	па-славацку	Adv
па-славенску	па-славенску	Adv
па-славянску	па-славянску	Adv
па-слановаму	па-слановаму	Adv
па-снайперску	па-снайперску	Adv
па-спартыўнаму	па-спартыўнаму	Adv
па-справядліваму	па-справядліваму	Adv
па-сталічнаму	па-сталічнаму	Adv
па-старагабрэйску	па-старагабрэйску	Adv
па-старагрэцку	па-старагрэцку	Adv
па-старадаўняму	па-старадаўняму	Adv
па-старажытнаму	па-старажытнаму	Adv
па-старамоднаму	па-старамоднаму	Adv
па-старасвецку	па-старасвецку	Adv
па-старому	па-старому	Adv
па-старэчаму	па-старэчаму	Adv
па-старэчы	па-старэчы	Adv
па-стаханаўску	па-стаханаўску	Adv
па-студэнцку	па-студэнцку	Adv
па-сувораўску	па-сувораўску	Adv
па-сур'ёзнаму	па-сур'ёзнаму	Adv
па-суседску	па-суседску	Adv
па-сухому	па-сухому	Adv
па-сучаснаму	па-сучаснаму	Adv
па-сяброўску	па-сяброўску	Adv
па-сялянскі	па-сялянскі	Adv
па-сялянску	па-сялянску	Adv
па-сямейнаму	па-сямейнаму	Adv
па-таварыску	па-таварыску	Adv
па-таджыкску	па-таджыкску	Adv
па-тайску	па-тайску	Adv
па-талстоўску	па-талстоўску	Adv
па-татарску	па-татарску	Adv
па-туркменску	па-туркменску	Adv
па-турысцку	па-турысцку	Adv
па-турэцку	па-турэцку	Adv
па-тутэйшаму	па-тутэйшаму	Adv
па-тэатральнаму	па-тэатральнаму	Adv
па-ўзбекску	па-ўзбекску	Adv
па-ўкраінску	па-ўкраінску	Adv
па-ўсходняму	па-ўсходняму	Adv
па-ўчарашняму	па-ўчарашняму	Adv
па-фальклорнаму	па-фальклорнаму	Adv
па-фарысейску	па-фарысейску	Adv
па-філасофску	па-філасофску	Adv
па-фінску	па-фінску	Adv
па-флоцку	па-флоцку	Adv
па-франтавому	па-франтавому	Adv
па-французску	па-французску	Adv
па-хакаску	па-хакаску	Adv
па-хамску	па-хамску	Adv
па-ханжаску	па-ханжаску	Adv
па-хатняму	па-хатняму	Adv
па-хвацку	па-хвацку	Adv
па-хітраму	па-хітраму	Adv
па-хлапецку	па-хлапецку	Adv
па-хлапчукоўску	па-хлапчукоўску	Adv
па-хрысціянску	па-хрысціянску	Adv
па-хуткаму	па-хуткаму	Adv
па-царкоўнаму	па-царкоўнаму	Adv
па-царску	па-царску	Adv
па-цыганску	па-цыганску	Adv
па-цыркавому	па-цыркавому	Adv
па-цяперашняму	па-цяперашняму	Adv
па-чалавечы	па-чалавечы	Adv
па-чарапашы	па-чарапашы	Adv
па-чаркеску	па-чаркеску	Adv
па-чартоўску	па-чартоўску	Adv
па-чорнаму	па-чорнаму	Adv
па-чувашску	па-чувашску	Adv
па-чужому	па-чужому	Adv
па-чыноўніцку	па-чыноўніцку	Adv
па-чэркеску	па-чэркеску	Adv
па-чэшску	па-чэшску	Adv
па-шатландску	па-шатландску	Adv
па-шведску	па-шведску	Adv
па-швейцарску	па-швейцарску	Adv
па-школьнаму	па-школьнаму	Adv
па-шляхетнаму	па-шляхетнаму	Adv
па-шляхецку	па-шляхецку	Adv
па-шустраму	па-шустраму	Adv
па-шчыраму	па-шчыраму	Adv
па-шчырасці	па-шчырасці	Adv
па-эстонску	па-эстонску	Adv
па-югаслаўску	па-югаслаўску	Adv
па-юнацку	па-юнацку	Adv
па-юначаму	па-юначаму	Adv
па-юначы	па-юначы	Adv
па-ягонаму	па-ягонаму	Adv
па-язычніцку	па-язычніцку	Adv
па-якому	па-якому	Adv
па-якуцку	па-якуцку	Adv
па-японску	па-японску	Adv
паабапал	паабапал	Adv
пааркушна	пааркушна	Adv
паартыкульна	паартыкульна	Adv
паасобку	паасобку	Adv
паасобна	паасобна	Adv
пабатальённа	пабатальённа	Adv
паблажліва	паблажліва	Adv
паблізу	паблізу	Adv
пабожна	пабожна	Adv
паболей	паболей	Adv
пабольш	пабольш	Adv
пабрыгадна	пабрыгадна	Adv
павабліва	павабліва	Adv
павабна	павабна	Adv
паважліва	паважліва	Adv
паважна	паважна	Adv
павальна	павальна	Adv
павек	павек	Adv
паверсе	паверсе	Adv
паверх	паверх	Adv
паволі	паволі	Adv
павучальна	павучальна	Adv
павярхоўна	павярхоўна	Adv
пагадзінна	пагадзінна	Adv
пагадова	пагадова	Adv
пагалоўна	пагалоўна	Adv
пагарджальна	пагарджальна	Adv
пагардліва	пагардліва	Adv
пагатоў	пагатоў	Adv
пагектарна	пагектарна	Adv
пагібельна	пагібельна	Adv
паглыблена	паглыблена	Adv
пагражальна	пагражальна	Adv
пагрозліва	пагрозліва	Adv
пагрозна	пагрозна	Adv
падазрона	падазрона	Adv
падалей	падалей	Adv
падатліва	падатліва	Adv
падаўна	падаўна	Adv
падзённа	падзённа	Adv
падкусліва	падкусліва	Adv
падлізліва	падлізліва	Adv
падложна	падложна	Adv
падманліва	падманліва	Adv
падманна	падманна	Adv
падобна	падобна	Adv
падоўгу	падоўгу	Adv
падоўжана	падоўжана	Adv
падоўжна	падоўжна	Adv
падпаследак	падпаследак	Adv
падпахі	падпахі	Adv
падпашкі	падпашкі	Adv
падпольна	падпольна	Adv
падрад	падрад	Adv
падсвядома	падсвядома	Adv
падскокам	падскокам	Adv
падскурна	падскурна	Adv
падслепавата	падслепавата	Adv
падспудна	падспудна	Adv
падстаўна	падстаўна	Adv
падушна	падушна	Adv
падчас	падчас	Adv
падчыстую	падчыстую	Adv
падыспадам	падыспадам	Adv
падэкадна	падэкадна	Adv
пажадана	пажадана	Adv
пажадліва	пажадліва	Adv
пажаранебяспечна	пажаранебяспечна	Adv
пажыццёва	пажыццёва	Adv
пазавуголлю	пазавуголлю	Adv
пазадзе	пазадзе	Adv
пазалетась	пазалетась	Adv
пазапланава	пазапланава	Adv
пазарэз	пазарэз	Adv
пазаўтра	пазаўтра	Adv
пазаўчора	пазаўчора	Adv
пазачаргова	пазачаргова	Adv
пазаштатна	пазаштатна	Adv
пазітыўна	пазітыўна	Adv
пазменна	пазменна	Adv
пазнавата	пазнавата	Adv
пазнюсенька	пазнюсенька	Adv
пазнютка	пазнютка	Adv
пайменна	пайменна	Adv
паказальна	паказальна	Adv
пакалонна	пакалонна	Adv
паката	паката	Adv
пакаянна	пакаянна	Adv
паквартальна	паквартальна	Adv
пакорліва	пакорліва	Adv
пакорна	пакорна	Adv
пакручаста	пакручаста	Adv
пакрысе	пакрысе	Adv
пакрыўджана	пакрыўджана	Adv
пакрыху	пакрыху	Adv
пакрышачку	пакрышачку	Adv
пакрышку	пакрышку	Adv
пакутліва	пакутліва	Adv
пакутна	пакутна	Adv
палахліва	палахліва	Adv
палёганьку	палёганьку	Adv
палёгеньку	палёгеньку	Adv
палегчана	палегчана	Adv
палітычна	палітычна	Adv
палка	палка	Adv
палюбоўна	палюбоўна	Adv
памаленьку	памаленьку	Adv
памалу	памалу	Adv
памаўзліва	памаўзліва	Adv
памесячна	памесячна	Adv
памінутна	памінутна	Adv
памногу	памногу	Adv
памылкова	памылкова	Adv
памяркоўна	памяркоўна	Adv
панавата	панавата	Adv
панадліва	панадліва	Adv
паначы	паначы	Adv
панегірычна	панегірычна	Adv
панізе	панізе	Adv
панічна	панічна	Adv
панура	панура	Adv
паныла	паныла	Adv
паняволі	паняволі	Adv
панятліва	панятліва	Adv
папалам	папалам	Adv
папарна	папарна	Adv
папаўдні	папаўдні	Adv
папацёмку	папацёмку	Adv
паперад	паперад	Adv
папераджальна	папераджальна	Adv
паперадзе	паперадзе	Adv
папераменна	папераменна	Adv
папоўначы	папоўначы	Adv
папоўніцы	папоўніцы	Adv
папоцемку	папоцемку	Adv
папраўдзе	папраўдзе	Adv
папраўна	папраўна	Adv
папросту	папросту	Adv
папулярна	папулярна	Adv
папярок	папярок	Adv
папярэдне	папярэдне	Adv
парадаксальна	парадаксальна	Adv
парадкам	парадкам	Adv
парадна	парадна	Adv
парадыйна	парадыйна	Adv
параённа	параённа	Adv
паражняком	паражняком	Adv
паралельна	паралельна	Adv
парамі	парамі	Adv
параўнальна	параўнальна	Adv
параўнаўча	параўнаўча	Adv
парна	парна	Adv
паротна	паротна	Adv
пароўну	пароўну	Adv
парою	парою	Adv
партыйна	партыйна	Adv
парцыённа	парцыённа	Adv
паршыва	паршыва	Adv
парывіста	парывіста	Adv
пасезонна	пасезонна	Adv
пасіўна	пасіўна	Adv
паскудна	паскудна	Adv
паслойна	паслойна	Adv
паслоўна	паслоўна	Adv
паслужліва	паслужліва	Adv
паслухмяна	паслухмяна	Adv
пасля	пасля	Adv
паслязаўтра	паслязаўтра	Adv
пасмертна	пасмертна	Adv
пасмяротна	пасмяротна	Adv
паспешліва	паспешліва	Adv
паспешна	паспешна	Adv
паспяхова	паспяхова	Adv
пасрэдна	пасрэдна	Adv
пастаянна	пастаянна	Adv
паступальна	паступальна	Adv
паступова	паступова	Adv
пастфактум	пастфактум	Adv
пасутачна	пасутачна	Adv
пасуху	пасуху	Adv
пасярод	пасярод	Adv
пасяродку	пасяродку	Adv
пасярэдзіне	пасярэдзіне	Adv
патаемна	патаемна	Adv
паталагічна	паталагічна	Adv
патомна	патомна	Adv
патрабавальна	патрабавальна	Adv
патроху	патроху	Adv
патрошку	патрошку	Adv
патрыярхальна	патрыярхальна	Adv
патрыятычна	патрыятычна	Adv
патрэбна	патрэбна	Adv
патыднёва	патыднёва	Adv
патэнцыйна	патэнцыйна	Adv
патэнцыяльна	патэнцыяльна	Adv
патэтычна	патэтычна	Adv
паўжартам	паўжартам	Adv
паўзверх	паўзверх	Adv
паўзводна	паўзводна	Adv
паўзком	паўзком	Adv
паўкругам	паўкругам	Adv
паўнавартасна	паўнавартасна	Adv
паўнагучна	паўнагучна	Adv
паўнакроўна	паўнакроўна	Adv
паўнапраўна	паўнапраўна	Adv
паўнацэнна	паўнацэнна	Adv
паўночы	паўночы	Adv
паўнюсенька	паўнюсенька	Adv
паўнютка	паўнютка	Adv
паўрочна	паўрочна	Adv
паўсонна	паўсонна	Adv
паўстолькі	паўстолькі	Adv
паўсур'ёзна	паўсур'ёзна	Adv
паўсядзённа	паўсядзённа	Adv
паўторна	паўторна	Adv
пафасна	пафасна	Adv
пахабна	пахабна	Adv
пахвальна	пахвальна	Adv
пахіла	пахіла	Adv
пахмурна	пахмурна	Adv
паціхеньку	паціхеньку	Adv
паціху	паціху	Adv
пачаргова	пачаргова	Adv
пачасова	пачасова	Adv
пачаткова	пачаткова	Adv
пачкамі	пачкамі	Adv
пачціва	пачціва	Adv
пачэсна	пачэсна	Adv
паштучна	паштучна	Adv
пашырана	пашырана	Adv
паэлементна	паэлементна	Adv
паэскадронна	паэскадронна	Adv
паэтапна	паэтапна	Adv
паэшалонна	паэшалонна	Adv
педагагічна	педагагічна	Adv
педантычна	педантычна	Adv
пераборліва	пераборліва	Adv
пераважна	пераважна	Adv
перавялічана	перавялічана	Adv
перадам	перадам	Adv
перадусім	перадусім	Adv
пераканальна	пераканальна	Adv
пераканана	пераканана	Adv
пераканаўча	пераканаўча	Adv
перакрыжавана	перакрыжавана	Adv
пералівіста	пералівіста	Adv
перамаганосна	перамаганосна	Adv
пераменліва	пераменліва	Adv
пераможна	пераможна	Adv
перапынкамі	перапынкамі	Adv
перарывіста	перарывіста	Adv
перасцерагальна	перасцерагальна	Adv
перманентна	перманентна	Adv
пернікава	пернікава	Adv
перпендыкулярна	перпендыкулярна	Adv
персанальна	персанальна	Adv
перспектыўна	перспектыўна	Adv
перш	перш	Adv
перш-наперш	перш-наперш	Adv
першабытна	першабытна	Adv
першапачаткова	першапачаткова	Adv
першародна	першародна	Adv
перыядычна	перыядычна	Adv
песімістычна	песімістычна	Adv
пеўнікам	пеўнікам	Adv
пехам	пехам	Adv
пехатой	пехатой	Adv
пехатою	пехатою	Adv
пешкам	пешкам	Adv
пешкі	пешкі	Adv
пешшу	пешшу	Adv
пікантна	пікантна	Adv
піскліва	піскліва	Adv
пісклява	пісклява	Adv
пісьменна	пісьменна	Adv
пісьмова	пісьмова	Adv
піцыката	піцыката	Adv
пішчом	пішчом	Adv
піяна	піяна	Adv
піянісіма	піянісіма	Adv
плазам	плазам	Adv
плаксіва	плаксіва	Adv
планава	планава	Adv
планамерна	планамерна	Adv
платанічна	платанічна	Adv
платна	платна	Adv
плённа	плённа	Adv
плоска	плоска	Adv
плытка	плытка	Adv
пляската	пляската	Adv
побаку	побаку	Adv
побач	побач	Adv
побліз	побліз	Adv
поблізу	поблізу	Adv
повідну	повідну	Adv
подаўна	подаўна	Adv
подбегам	подбегам	Adv
подбежкам	подбежкам	Adv
подла	подла	Adv
подскакам	подскакам	Adv
поедам	поедам	Adv
позненька	позненька	Adv
покатам	покатам	Adv
поклічна	поклічна	Adv
помеж	помеж	Adv
помсліва	помсліва	Adv
поначы	поначы	Adv
понізу	понізу	Adv
поперак	поперак	Adv
поплеч	поплеч	Adv
попусту	попусту	Adv
пораўні	пораўні	Adv
порстка	порстка	Adv
поруч	поруч	Adv
поседам	поседам	Adv
посуху	посуху	Adv
потайкам	потайкам	Adv
потайкі	потайкі	Adv
потарч	потарч	Adv
потым	потым	Adv
потырч	потырч	Adv
поўнасцю	поўнасцю	Adv
поўнаўладна	поўнаўладна	Adv
похапкам	похапкам	Adv
поцемкам	поцемкам	Adv
поцягам	поцягам	Adv
пошапкам	пошапкам	Adv
пошвыркам	пошвыркам	Adv
пошла	пошла	Adv
праблематычна	праблематычна	Adv
праблемна	праблемна	Adv
правакацыйна	правакацыйна	Adv
правамерна	правамерна	Adv
правамоцна	правамоцна	Adv
праваруч	праваруч	Adv
праведна	праведна	Adv
правей	правей	Adv
прагавіта	прагавіта	Adv
прагматычна	прагматычна	Adv
прагна	прагна	Adv
прадбачліва	прадбачліва	Adv
прадказальна	прадказальна	Adv
прадметна	прадметна	Adv
прадстаўніча	прадстаўніча	Adv
прадузята	прадузята	Adv
прадукцыйна	прадукцыйна	Adv
прадумана	прадумана	Adv
праездам	праездам	Adv
пражэрліва	пражэрліва	Adv
празаічна	празаічна	Adv
празмерна	празмерна	Adv
празорліва	празорліва	Adv
празрыста	празрыста	Adv
практычна	практычна	Adv
прамалінейна	прамалінейна	Adv
прамудра	прамудра	Adv
прамыслова	прамыслова	Adv
прамяніста	прамяніста	Adv
пранізліва	пранізліва	Adv
пранікліва	пранікліва	Adv
пранікнёна	пранікнёна	Adv
прапарцыянальна	прапарцыянальна	Adv
праразліва	праразліва	Adv
прарэзліва	прарэзліва	Adv
прастадушна	прастадушна	Adv
прасторава	прасторава	Adv
прасцютка	прасцютка	Adv
прасцяком	прасцяком	Adv
пратакольна	пратакольна	Adv
праўдападобна	праўдападобна	Adv
праўцом	праўцом	Adv
прафесійна	прафесійна	Adv
прафесіянальна	прафесіянальна	Adv
працавіта	працавіта	Adv
працверажальна	працверажальна	Adv
працягла	працягла	Adv
працяжліва	працяжліва	Adv
прачула	прачула	Adv
просталінейна	просталінейна	Adv
проці	проці	Adv
процізаконна	процізаконна	Adv
процілегла	процілегла	Adv
проціў	проціў	Adv
процьма	процьма	Adv
пругка	пругка	Adv
прутка	прутка	Adv
прыбліжана	прыбліжана	Adv
прыблізна	прыблізна	Adv
прыбыткова	прыбыткова	Adv
прывабліва	прывабліва	Adv
прыватна	прыватна	Adv
прывітальна	прывітальна	Adv
прыглушана	прыглушана	Adv
прыгнечана	прыгнечана	Adv
прыгнятальна	прыгнятальна	Adv
прыдзірліва	прыдзірліва	Adv
прыдуркавата	прыдуркавата	Adv
прыжмурана	прыжмурана	Adv
прыжыццёва	прыжыццёва	Adv
прыземлена	прыземлена	Adv
прыкладна	прыкладна	Adv
прыкметна	прыкметна	Adv
прыкра	прыкра	Adv
прылюдна	прылюдна	Adv
прымальна	прымальна	Adv
прыметна	прыметна	Adv
прымірыцельна	прымірыцельна	Adv
прымірэнча	прымірэнча	Adv
прымусова	прымусова	Adv
прымяняльна	прымяняльна	Adv
прынадна	прынадна	Adv
прынамсі	прынамсі	Adv
прыніжальна	прыніжальна	Adv
прынцыпова	прынцыпова	Adv
прыскорана	прыскорана	Adv
прыступна	прыступна	Adv
прытворна	прытворна	Adv
прытном	прытном	Adv
прытоена	прытоена	Adv
прытульна	прытульна	Adv
прыўдала	прыўдала	Adv
прыхваткам	прыхваткам	Adv
прыхваткамі	прыхваткамі	Adv
прыхільна	прыхільна	Adv
прыцемкам	прыцемкам	Adv
прыцемкамі	прыцемкамі	Adv
прыцемна	прыцемна	Adv
прыцішана	прыцішана	Adv
прыцэльна	прыцэльна	Adv
прыязна	прыязна	Adv
прыярытэтна	прыярытэтна	Adv
прэдыкатыўна	прэдыкатыўна	Adv
прэзентабельна	прэзентабельна	Adv
прэсна	прэсна	Adv
прэста	прэста	Adv
прэстыжна	прэстыжна	Adv
прэстысіма	прэстысіма	Adv
прэтэнцыёзна	прэтэнцыёзна	Adv
прэч	прэч	Adv
псеўда-патрыятычна	псеўда-патрыятычна	Adv
псіхалагічна	псіхалагічна	Adv
псіхічна	псіхічна	Adv
публіцыстычна	публіцыстычна	Adv
публічна	публічна	Adv
пудка	пудка	Adv
пужліва	пужліва	Adv
пуката	пуката	Adv
пункцірна	пункцірна	Adv
пуста	пуста	Adv
пуставата	пуставата	Adv
пустынна	пустынна	Adv
пустэльна	пустэльна	Adv
пыльна	пыльна	Adv
пытальна	пытальна	Adv
пэўна	пэўна	Adv
пэўне	пэўне	Adv
пявуча	пявуча	Adv
пякельна	пякельна	Adv
пякуча	пякуча	Adv
пярэста	пярэста	Adv
пяцікратна	пяцікратна	Adv
пяшком	пяшком	Adv
пяшэчкам	пяшэчкам	Adv
рабалепна	рабалепна	Adv
радком	радком	Adv
радыеактыўна	радыеактыўна	Adv
радыкальна	радыкальна	Adv
радыяльна	радыяльна	Adv
радыяцыйна	радыяцыйна	Adv
раз	раз	Adv
раз-пораз	раз-пораз	Adv
раз-поразу	раз-поразу	Adv
раз'яднана	раз'яднана	Adv
разава	разава	Adv
разбуральна	разбуральна	Adv
разбэшчана	разбэшчана	Adv
разважліва	разважліва	Adv
разважна	разважна	Adv
развітальна	развітальна	Adv
разгоніста	разгоніста	Adv
разгромна	разгромна	Adv
разгульна	разгульна	Adv
раздзельна	раздзельна	Adv
раздражнёна	раздражнёна	Adv
раздумліва	раздумліва	Adv
разлапіста	разлапіста	Adv
разлютавана	разлютавана	Adv
размашыста	размашыста	Adv
разумова	разумова	Adv
ракам	ракам	Adv
ракачом	ракачом	Adv
рамачна	рамачна	Adv
ранавата	ранавата	Adv
раней	раней	Adv
раненька	раненька	Adv
раніцай	раніцай	Adv
раніцой	раніцой	Adv
раніцою	раніцою	Adv
ранкам	ранкам	Adv
ранюсенька	ранюсенька	Adv
ранютка	ранютка	Adv
раптам	раптам	Adv
раптоўна	раптоўна	Adv
расава	расава	Adv
раскаціста	раскаціста	Adv
раскідана	раскідана	Adv
распеўна	распеўна	Adv
расплывіста	расплывіста	Adv
расплыўчата	расплыўчата	Adv
рассеяна	рассеяна	Adv
расхлябана	расхлябана	Adv
расчаравана	расчаравана	Adv
раўнадушна	раўнадушна	Adv
раўназначна	раўназначна	Adv
раўнамерна	раўнамерна	Adv
раўнапраўна	раўнапраўна	Adv
раўнацэнна	раўнацэнна	Adv
раўніва	раўніва	Adv
раўнюсенька	раўнюсенька	Adv
раўнютка	раўнютка	Adv
рахмана	рахмана	Adv
рачком	рачком	Adv
рашуча	рашуча	Adv
роблена	роблена	Adv
родна	родна	Adv
роем	роем	Adv
розна	розна	Adv
рознабакова	рознабакова	Adv
рознакалярова	рознакалярова	Adv
росна	росна	Adv
роспачна	роспачна	Adv
россыпам	россыпам	Adv
роўненька	роўненька	Adv
рубам	рубам	Adv
рубінава	рубінава	Adv
рудавата	рудавата	Adv
румяна	румяна	Adv
рупліва	рупліва	Adv
рухома	рухома	Adv
руцінна	руцінна	Adv
рызыкоўна	рызыкоўна	Adv
рыкашэтам	рыкашэтам	Adv
рынкава	рынкава	Adv
рыссю	рыссю	Adv
рытарычна	рытарычна	Adv
рытуальна	рытуальна	Adv
рыўком	рыўком	Adv
рыхла	рыхла	Adv
рыхтык	рыхтык	Adv
рэабілітацыйна	рэабілітацыйна	Adv
рэалістычна	рэалістычна	Adv
рэвалюцыйна	рэвалюцыйна	Adv
рэзва	рэзва	Adv
рэзка	рэзка	Adv
рэзонна	рэзонна	Adv
рэзультатыўна	рэзультатыўна	Adv
рэкордна	рэкордна	Adv
рэльефна	рэльефна	Adv
рэнтабельна	рэнтабельна	Adv
рэспектабельна	рэспектабельна	Adv
рэтраспектыўна	рэтраспектыўна	Adv
рэфлекторна	рэфлекторна	Adv
рэфлектыўна	рэфлектыўна	Adv
сакавіта	сакавіта	Adv
сакрушальна	сакрушальна	Adv
саладкавата	саладкавата	Adv
салідарна	салідарна	Adv
салідна	салідна	Adv
самаадвольна	самаадвольна	Adv
самааддана	самааддана	Adv
самаахвярна	самаахвярна	Adv
самавіта	самавіта	Adv
самавольна	самавольна	Adv
самавукам	самавукам	Adv
самадавольна	самадавольна	Adv
самадзяржаўна	самадзяржаўна	Adv
самадумам	самадумам	Adv
самазабыўна	самазабыўна	Adv
самазадаволена	самазадаволена	Adv
самаздаволена	самаздаволена	Adv
самаініцыятыўна	самаініцыятыўна	Adv
самакатам	самакатам	Adv
самакрытычна	самакрытычна	Adv
самалюбіва	самалюбіва	Adv
самалюбна	самалюбна	Adv
саманадзейна	саманадзейна	Adv
самапасам	самапасам	Adv
самаплывам	самаплывам	Adv
самастойна	самастойна	Adv
саматугам	саматугам	Adv
саматужна	саматужна	Adv
самаўладна	самаўладна	Adv
самаўпраўна	самаўпраўна	Adv
самаўпэўнена	самаўпэўнена	Adv
самаходам	самаходам	Adv
самаходзь	самаходзь	Adv
самахоць	самахоць	Adv
самацёкам	самацёкам	Adv
самачынна	самачынна	Adv
самотна	самотна	Adv
санавіта	санавіта	Adv
санліва	санліва	Adv
саноўна	саноўна	Adv
сапраўды	сапраўды	Adv
саркастычна	саркастычна	Adv
саромліва	саромліва	Adv
саромна	саромна	Adv
сатырычна	сатырычна	Adv
саўсім	саўсім	Adv
сацыяльна	сацыяльна	Adv
свавольна	свавольна	Adv
сварліва	сварліва	Adv
сваявольна	сваявольна	Adv
свежа	свежа	Adv
своеасабліва	своеасабліва	Adv
своечасова	своечасова	Adv
свядома	свядома	Adv
свята	свята	Adv
святлютка	святлютка	Adv
сезонна	сезонна	Adv
сектаральна	сектаральна	Adv
сёлета	сёлета	Adv
семантычна	семантычна	Adv
сёння	сёння	Adv
сенсацыйна	сенсацыйна	Adv
сентэнцыйна	сентэнцыйна	Adv
сепаратна	сепаратна	Adv
серыйна	серыйна	Adv
сіберна	сіберна	Adv
сіверна	сіверна	Adv
сілай	сілай	Adv
сілаю	сілаю	Adv
сілком	сілком	Adv
сімвалічна	сімвалічна	Adv
сіметрычна	сіметрычна	Adv
сімптаматычна	сімптаматычна	Adv
сінхронна	сінхронна	Adv
сіпла	сіпла	Adv
сіратліва	сіратліва	Adv
сіроча	сіроча	Adv
сістэматычна	сістэматычна	Adv
сістэмна	сістэмна	Adv
скажона	скажона	Adv
скандальна	скандальна	Adv
сканфужана	сканфужана	Adv
сканцэнтравана	сканцэнтравана	Adv
скарацечна	скарацечна	Adv
скарочана	скарочана	Adv
скачкападобна	скачкападобна	Adv
сквапна	сквапна	Adv
скептычна	скептычна	Adv
скокам	скокам	Adv
скончана	скончана	Adv
скоранька	скоранька	Adv
скоса	скоса	Adv
скрозь	скрозь	Adv
скромна	скромна	Adv
скрупулёзна	скрупулёзна	Adv
скрушліва	скрушліва	Adv
скрушна	скрушна	Adv
скрыва	скрыва	Adv
скрыжавана	скрыжавана	Adv
скрыпуча	скрыпуча	Adv
скрытна	скрытна	Adv
скрыўлена	скрыўлена	Adv
скульптурна	скульптурна	Adv
скупавата	скупавата	Adv
слабавата	слабавата	Adv
слабка	слабка	Adv
славута	славута	Adv
следам	следам	Adv
слёзна	слёзна	Adv
слепа	слепа	Adv
слепавата	слепавата	Adv
слізка	слізка	Adv
слінява	слінява	Adv
слотна	слотна	Adv
слухмяна	слухмяна	Adv
слушна	слушна	Adv
слюнява	слюнява	Adv
слязліва	слязліва	Adv
сляпуча	сляпуча	Adv
смешнавата	смешнавата	Adv
смуродна	смуродна	Adv
смутна	смутна	Adv
смяротна	смяротна	Adv
смяртэльна	смяртэльна	Adv
снатворна	снатворна	Adv
снежна	снежна	Adv
сола	сола	Adv
солана	солана	Adv
сольна	сольна	Adv
сонечна	сонечна	Adv
сонна	сонна	Adv
сорамна	сорамна	Adv
сослепу	сослепу	Adv
сосмеху	сосмеху	Adv
сотнямі	сотнямі	Adv
сп'яна	сп'яна	Adv
спаважна	спаважна	Adv
спагадзя	спагадзя	Adv
спагадліва	спагадліва	Adv
спагадна	спагадна	Adv
спадзіста	спадзіста	Adv
спаднізу	спаднізу	Adv
спадручна	спадручна	Adv
спадсподу	спадсподу	Adv
спадцішка	спадцішка	Adv
спадылба	спадылба	Adv
спадыспаду	спадыспаду	Adv
спакваля	спакваля	Adv
спакон	спакон	Adv
спакусліва	спакусліва	Adv
спакусна	спакусна	Adv
спакушальна	спакушальна	Adv
спалохана	спалохана	Adv
спантанна	спантанна	Adv
спарадычна	спарадычна	Adv
спарана	спарана	Adv
спартыўна	спартыўна	Adv
спасцярожліва	спасцярожліва	Adv
спатайка	спатайка	Adv
спаўдня	спаўдня	Adv
спаўна	спаўна	Adv
спачатку	спачатку	Adv
спачувальна	спачувальна	Adv
спераду	спераду	Adv
спершапачатку	спершапачатку	Adv
спехам	спехам	Adv
спецыфічна	спецыфічна	Adv
спецыяльна	спецыяльна	Adv
спешна	спешна	Adv
спіраллю	спіраллю	Adv
спіральна	спіральна	Adv
сподам	сподам	Adv
спорна	спорна	Adv
спотайку	спотайку	Adv
справа	справа	Adv
спрадвеку	спрадвеку	Adv
спрадвечна	спрадвечна	Adv
спрактыкавана	спрактыкавана	Adv
спрасонку	спрасонку	Adv
спрасоння	спрасоння	Adv
спрошчана	спрошчана	Adv
спрыяльна	спрыяльна	Adv
спрэс	спрэс	Adv
спрэчна	спрэчна	Adv
спуджана	спуджана	Adv
спуду	спуду	Adv
спусціста	спусціста	Adv
спякотна	спякотна	Adv
спярша	спярша	Adv
стабільна	стабільна	Adv
стаічна	стаічна	Adv
сталёва	сталёва	Adv
стандартна	стандартна	Adv
станоўча	станоўча	Adv
стапрацэнтна	стапрацэнтна	Adv
старчаком	старчаком	Adv
старчма	старчма	Adv
статыстычна	статыстычна	Adv
статычна	статычна	Adv
стаўма	стаўма	Adv
стаяком	стаяком	Adv
стоена	стоена	Adv
стойка	стойка	Adv
стойма	стойма	Adv
столькі	столькі	Adv
стомлена	стомлена	Adv
сторапу	сторапу	Adv
сторч	сторч	Adv
страката	страката	Adv
страсна	страсна	Adv
стратна	стратна	Adv
стратэгічна	стратэгічна	Adv
страшнавата	страшнавата	Adv
страшэнна	страшэнна	Adv
строма	строма	Adv
стромка	стромка	Adv
структурна	структурна	Adv
стрымгалоў	стрымгалоў	Adv
ступой	ступой	Adv
ступою	ступою	Adv
стылістычна	стылістычна	Adv
стыльна	стыльна	Adv
стыхійна	стыхійна	Adv
стэнаграфічна	стэнаграфічна	Adv
стэрэатыпна	стэрэатыпна	Adv
суб'ектыўна	суб'ектыўна	Adv
сублімацыйна	сублімацыйна	Adv
сугучна	сугучна	Adv
сударгава	сударгава	Adv
сукравічна	сукравічна	Adv
суладна	суладна	Adv
сумарна	сумарна	Adv
сумбурна	сумбурна	Adv
сумесна	сумесна	Adv
сумліва	сумліва	Adv
сумнавата	сумнавата	Adv
сумнеўна	сумнеўна	Adv
сумотна	сумотна	Adv
сумыслу	сумыслу	Adv
сумысля	сумысля	Adv
сумысна	сумысна	Adv
сумятліва	сумятліва	Adv
супакоена	супакоена	Adv
супакойліва	супакойліва	Adv
супакойна	супакойна	Adv
суперсучасна	суперсучасна	Adv
супольна	супольна	Adv
супраць	супраць	Adv
супроць	супроць	Adv
супярэчліва	супярэчліва	Adv
суразмерна	суразмерна	Adv
сусветна	сусветна	Adv
сутаргава	сутаргава	Adv
сутнасна	сутнасна	Adv
сутула	сутула	Adv
суха-насуха	суха-насуха	Adv
сухавата	сухавата	Adv
суцэльна	суцэльна	Adv
сучасна	сучасна	Adv
сфарцанда	сфарцанда	Adv
схаластычна	схаластычна	Adv
схематычна	схематычна	Adv
сходна	сходна	Adv
сцвярджальна	сцвярджальна	Adv
сцеражліва	сцеражліва	Adv
сціпла	сціпла	Adv
сцісла	сцісла	Adv
сцішана	сцішана	Adv
сцішка	сцішка	Adv
сцішна	сцішна	Adv
сцэнічна	сцэнічна	Adv
сыравата	сыравата	Adv
сырцом	сырцом	Adv
сэксапільна	сэксапільна	Adv
сэксуальна	сэксуальна	Adv
сэнсава	сэнсава	Adv
сюжэтна	сюжэтна	Adv
сяголета	сяголета	Adv
сягоння	сягоння	Adv
сямейна	сямейна	Adv
сярдзіта	сярдзіта	Adv
сярэдне	сярэдне	Adv
тагасветна	тагасветна	Adv
таемна	таемна	Adv
тайком	тайком	Adv
тайна	тайна	Adv
тактыльна	тактыльна	Adv
тактычна	тактычна	Adv
талерантна	талерантна	Adv
талкова	талкова	Adv
танклява	танклява	Adv
танюсенька	танюсенька	Adv
таропка	таропка	Adv
тарчма	тарчма	Adv
татальна	татальна	Adv
таямніча	таямніча	Adv
творча	творча	Adv
тлумна	тлумна	Adv
тлуставата	тлуставата	Adv
тлятворна	тлятворна	Adv
толкам	толкам	Adv
толькі-толькі	толькі-толькі	Adv
тоненька	тоненька	Adv
топка	топка	Adv
трагічна	трагічна	Adv
традыцыйна	традыцыйна	Adv
трапна	трапна	Adv
трапятліва	трапятліва	Adv
траскуча	траскуча	Adv
трафарэтна	трафарэтна	Adv
траяка	траяка	Adv
тройчы	тройчы	Adv
трохі	трохі	Adv
трохкратна	трохкратна	Adv
троху	троху	Adv
трошачкі	трошачкі	Adv
трошкі	трошкі	Adv
трошку	трошку	Adv
трудна	трудна	Adv
трухам	трухам	Adv
трушком	трушком	Adv
трывала	трывала	Adv
трывіяльна	трывіяльна	Adv
трыумфальна	трыумфальна	Adv
трыўмфальна	трыўмфальна	Adv
трэмаланда	трэмаланда	Adv
тугавата	тугавата	Adv
тужліва	тужліва	Adv
туманна	туманна	Adv
тупавата	тупавата	Adv
тыпалагічна	тыпалагічна	Adv
тыпова	тыпова	Adv
тыранічна	тыранічна	Adv
тысячаразова	тысячаразова	Adv
тэарэтычна	тэарэтычна	Adv
тэатральна	тэатральна	Adv
тэзісна	тэзісна	Adv
тэкстуальна	тэкстуальна	Adv
тэлеграфна	тэлеграфна	Adv
тэлепатычна	тэлепатычна	Adv
тэматычна	тэматычна	Adv
тэмпераментна	тэмпераментна	Adv
тэндэнцыйна	тэндэнцыйна	Adv
тэрмінова	тэрмінова	Adv
тэрмічна	тэрмічна	Adv
тэрытарыяльна	тэрытарыяльна	Adv
тэт-а-тэт	тэт-а-тэт	Adv
тэхналагічна	тэхналагічна	Adv
тэхнічна	тэхнічна	Adv
убакі	убакі	Adv
убаку	убаку	Adv
убога	убога	Adv
убок	убок	Adv
уброд	уброд	Adv
уважліва	уважліва	Adv
уважна	уважна	Adv
увасьмёх	увасьмёх	Adv
увасьмярых	увасьмярых	Adv
увачавідкі	увачавідкі	Adv
уваччу	уваччу	Adv
уверсе	уверсе	Adv
уверх	уверх	Adv
увесну	увесну	Adv
увечар	увечар	Adv
увечары	увечары	Adv
увішна	увішна	Adv
увогуле	увогуле	Adv
уводдалі	уводдалі	Adv
уволю	уволю	Adv
увосень	увосень	Adv
увосьмера	увосьмера	Adv
увушшу	увушшу	Adv
увысь	увысь	Adv
увышыню	увышыню	Adv
увясну	увясну	Adv
угалоп	угалоп	Adv
угару	угару	Adv
угары	угары	Adv
углыб	углыб	Adv
углыбіню	углыбіню	Adv
угодліва	угодліва	Adv
уголас	уголас	Adv
угору	угору	Adv
удала	удала	Adv
удалеч	удалеч	Adv
удалечыні	удалечыні	Adv
удалечыню	удалечыню	Adv
удалячынь	удалячынь	Adv
ударна	ударна	Adv
удаўжкі	удаўжкі	Adv
удаўжыню	удаўжыню	Adv
удачліва	удачліва	Adv
удачна	удачна	Adv
удваіх	удваіх	Adv
удвайне	удвайне	Adv
удвая	удвая	Adv
удвух	удвух	Adv
удзвюх	удзвюх	Adv
удзевяцёх	удзевяцёх	Adv
удзевяцярых	удзевяцярых	Adv
удзень	удзень	Adv
удзесяцёх	удзесяцёх	Adv
удзесяцярых	удзесяцярых	Adv
удзячна	удзячна	Adv
удосталь	удосталь	Adv
удосыць	удосыць	Adv
удоўж	удоўж	Adv
удоўжкі	удоўжкі	Adv
удубальт	удубальт	Adv
удушліва	удушліва	Adv
ужо	ужо	Adv
узад	узад	Adv
узад-уперад	узад-уперад	Adv
узаемавыгадна	узаемавыгадна	Adv
узаемалюбоўна	узаемалюбоўна	Adv
узаемна	узаемна	Adv
узамен	узамен	Adv
узапар	узапар	Adv
узасос	узасос	Adv
узахапкі	узахапкі	Adv
узахапы	узахапы	Adv
узахлёб	узахлёб	Adv
узацяжку	узацяжку	Adv
узбоч	узбоч	Adv
узбуджальна	узбуджальна	Adv
узбуджана	узбуджана	Adv
узводна	узводна	Adv
узвышальна	узвышальна	Adv
уздагон	уздагон	Adv
уздоўж	уздоўж	Adv
уздымна	уздымна	Adv
узімку	узімку	Adv
узлавана	узлавана	Adv
узмоцнена	узмоцнена	Adv
узнёсла	узнёсла	Adv
узнята	узнята	Adv
узорна	узорна	Adv
узорыста	узорыста	Adv
узрадавана	узрадавана	Adv
узрушана	узрушана	Adv
укладна	укладна	Adv
уключна	уключна	Adv
украдкам	украдкам	Adv
укруг	укруг	Adv
укругавую	укругавую	Adv
укружка	укружка	Adv
укрутую	укрутую	Adv
уладарна	уладарна	Adv
уладжана	уладжана	Adv
уладкавана	уладкавана	Adv
уладна	уладна	Adv
уласна	уласна	Adv
уласнаручна	уласнаручна	Adv
уласціва	уласціва	Adv
улева	улева	Adv
улегцы	улегцы	Adv
улетку	улетку	Adv
улоўна	улоўна	Adv
улукаткі	улукаткі	Adv
улюбёна	улюбёна	Adv
умалотна	умалотна	Adv
умела	умела	Adv
умерана	умерана	Adv
умеючы	умеючы	Adv
уміг	уміг	Adv
умольна	умольна	Adv
умомант	умомант	Adv
умоўна	умоўна	Adv
унаём	унаём	Adv
унаймы	унаймы	Adv
унакідку	унакідку	Adv
унакладку	унакладку	Adv
уначы	уначы	Adv
уніжана	уніжана	Adv
уніз	уніз	Adv
унізе	унізе	Adv
унікальна	унікальна	Adv
унікліва	унікліва	Adv
унічыю	унічыю	Adv
уноччы	уноччы	Adv
уночы	уночы	Adv
унутр	унутр	Adv
унутрана	унутрана	Adv
унутры	унутры	Adv
унутрывенна	унутрывенна	Adv
унутрымышачна	унутрымышачна	Adv
унушальна	унушальна	Adv
упапад	упапад	Adv
упапярок	упапярок	Adv
упарта	упарта	Adv
упацёмку	упацёмку	Adv
упачатку	упачатку	Adv
уперавалку	уперавалку	Adv
уперагіб	уперагіб	Adv
уперагонкі	уперагонкі	Adv
уперад	уперад	Adv
уперадзе	уперадзе	Adv
уперамежку	уперамежку	Adv
уперамешку	уперамешку	Adv
уперахват	уперахват	Adv
упершыню	упершыню	Adv
уплаў	уплаў	Adv
упокат	упокат	Adv
упоперак	упоперак	Adv
упоравень	упоравень	Adv
употай	употай	Adv
употайкі	употайкі	Adv
употайку	употайку	Adv
упоцемках	упоцемках	Adv
упоцемку	упоцемку	Adv
управа	управа	Adv
упраўна	упраўна	Adv
упрочкі	упрочкі	Adv
упрыглядку	упрыглядку	Adv
упрыкуску	упрыкуску	Adv
упрысядкі	упрысядкі	Adv
упрытык	упрытык	Adv
упрыхваткі	упрыхваткі	Adv
упустую	упустую	Adv
упэўнена	упэўнена	Adv
упярэмешку	упярэмешку	Adv
урадліва	урадліва	Adv
уражана	уражана	Adv
уражліва	уражліва	Adv
ураз	ураз	Adv
уразбіўку	уразбіўку	Adv
уразброд	уразброд	Adv
уразвалку	уразвалку	Adv
ураздроб	ураздроб	Adv
уразлад	уразлад	Adv
уразліва	уразліва	Adv
уразнабой	уразнабой	Adv
уразнос	уразнос	Adv
уразрэз	уразрэз	Adv
уранку	уранку	Adv
уранні	уранні	Adv
урассыпную	урассыпную	Adv
урасцяжку	урасцяжку	Adv
ураўнаважана	ураўнаважана	Adv
урачыста	урачыста	Adv
уроскід	уроскід	Adv
уроскідку	уроскідку	Adv
уроссып	уроссып	Adv
уроссыпку	уроссыпку	Adv
урочна	урочна	Adv
урукапашную	урукапашную	Adv
уручную	уручную	Adv
урыўкамі	урыўкамі	Adv
урэгулявана	урэгулявана	Adv
урэшце	урэшце	Adv
усеабдымна	усеабдымна	Adv
усёабдымна	усёабдымна	Adv
усебакова	усебакова	Adv
уседліва	уседліва	Adv
усёмагутна	усёмагутна	Adv
усенародна	усенародна	Adv
ускорасці	ускорасці	Adv
ускосна	ускосна	Adv
услед	услед	Adv
услужліва	услужліва	Adv
услых	услых	Adv
усляпую	усляпую	Adv
усмак	усмак	Adv
усмешліва	усмешліва	Adv
усмятку	усмятку	Adv
устойліва	устойліва	Adv
устрывожана	устрывожана	Adv
усур'ёз	усур'ёз	Adv
усутыч	усутыч	Adv
усухамятку	усухамятку	Adv
усцешана	усцешана	Adv
усямерна	усямерна	Adv
усямёх	усямёх	Adv
усярэдзіне	усярэдзіне	Adv
усярэдзіну	усярэдзіну	Adv
усясветна	усясветна	Adv
утароплена	утароплена	Adv
утомна	утомна	Adv
утраіх	утраіх	Adv
утрайне	утрайне	Adv
утрапёна	утрапёна	Adv
утрая	утрая	Adv
утрох	утрох	Adv
утылітарна	утылітарна	Adv
ухаластую	ухаластую	Adv
ухвальна	ухвальна	Adv
ухіліста	ухіліста	Adv
уцёмную	уцёмную	Adv
уцешна	уцешна	Adv
уціхамірана	уціхамірана	Adv
учатырох	учатырох	Adv
учацвярых	учацвярых	Adv
учора	учора	Adv
учыстую	учыстую	Adv
учэпіста	учэпіста	Adv
ушасцёх	ушасцёх	Adv
ушасцярых	ушасцярых	Adv
ушчыльнена	ушчыльнена	Adv
ушчыльную	ушчыльную	Adv
ушчэнт	ушчэнт	Adv
ушыр	ушыр	Adv
ушыркі	ушыркі	Adv
ушырыню	ушырыню	Adv
уяўна	уяўна	Adv
файна	файна	Adv
факсіміле	факсіміле	Adv
фактаграфічна	фактаграфічна	Adv
фактычна	фактычна	Adv
факультатыўна	факультатыўна	Adv
фамільярна	фамільярна	Adv
фанабэрліва	фанабэрліва	Adv
фанабэрыста	фанабэрыста	Adv
фанатычна	фанатычна	Adv
фанетычна	фанетычна	Adv
фантастычна	фантастычна	Adv
фармальна	фармальна	Adv
фарсіравана	фарсіравана	Adv
фарсіста	фарсіста	Adv
фасонна	фасонна	Adv
фасфарычна	фасфарычна	Adv
фатаграфічна	фатаграфічна	Adv
фаталістычна	фаталістычна	Adv
фатальна	фатальна	Adv
фенаменальна	фенаменальна	Adv
фешэнебельна	фешэнебельна	Adv
фігуральна	фігуральна	Adv
фігурна	фігурна	Adv
фізічна	фізічна	Adv
фізіялагічна	фізіялагічна	Adv
фізкультурна	фізкультурна	Adv
фіктыўна	фіктыўна	Adv
філалагічна	філалагічна	Adv
філасафічна	філасафічна	Adv
філігранна	філігранна	Adv
фінансава	фінансава	Adv
фрагментарна	фрагментарна	Adv
франтавата	франтавата	Adv
франтальна	франтальна	Adv
фрывольна	фрывольна	Adv
фуксам	фуксам	Adv
фундаментальна	фундаментальна	Adv
функцыянальна	функцыянальна	Adv
хаатычна	хаатычна	Adv
халаднавата	халаднавата	Adv
халатна	халатна	Adv
халодна	халодна	Adv
хапатліва	хапатліва	Adv
хапком	хапком	Adv
хапу-лапу	хапу-лапу	Adv
характэрна	характэрна	Adv
хвалебна	хвалебна	Adv
хвалююча	хвалююча	Adv
хваравіта	хваравіта	Adv
хвацка	хвацка	Adv
хіжа	хіжа	Adv
хіла	хіла	Adv
хімічна	хімічна	Adv
хірургічна	хірургічна	Adv
хістка	хістка	Adv
хітравата	хітравата	Adv
хлебна	хлебна	Adv
хлусліва	хлусліва	Adv
хлюпотна	хлюпотна	Adv
хмарна	хмарна	Adv
хмура	хмура	Adv
ходу	ходу	Adv
хорам	хорам	Adv
храбра	храбра	Adv
храналагічна	храналагічна	Adv
хранічна	хранічна	Adv
хрыпла	хрыпла	Adv
хрыплавата	хрыплавата	Adv
хрыпліва	хрыпліва	Adv
хрэстаматыйна	хрэстаматыйна	Adv
хуткацечна	хуткацечна	Adv
хуценька	хуценька	Adv
хціва	хціва	Adv
цаліком	цаліком	Adv
цалкам	цалкам	Adv
цалком	цалком	Adv
цапу-лапу	цапу-лапу	Adv
цемнавата	цемнавата	Adv
цёмначы	цёмначы	Adv
цеплавата	цеплавата	Adv
цёпленька	цёпленька	Adv
цеснавата	цеснавата	Adv
цікаўна	цікаўна	Adv
ціхавата	ціхавата	Adv
ціхамірна	ціхамірна	Adv
ціханька	ціханька	Adv
ціхачом	ціхачом	Adv
ціхенечка	ціхенечка	Adv
ціхенька	ціхенька	Adv
ціхмяна	ціхмяна	Adv
ціхусенька	ціхусенька	Adv
ціхутка	ціхутка	Adv
цішком	цішком	Adv
цнатліва	цнатліва	Adv
цнотна	цнотна	Adv
цугам	цугам	Adv
цудадзейна	цудадзейна	Adv
цудам	цудам	Adv
цудатворна	цудатворна	Adv
цудоўна	цудоўна	Adv
цурком	цурком	Adv
цывільна	цывільна	Adv
цыклічна	цыклічна	Adv
цынічна	цынічна	Adv
цыркулярна	цыркулярна	Adv
цырымонна	цырымонна	Adv
цьмянавата	цьмянавата	Adv
цягуча	цягуча	Adv
цяжанька	цяжанька	Adv
цяжкавата	цяжкавата	Adv
цялесна	цялесна	Adv
цямнюсенька	цямнюсенька	Adv
цянькамі	цянькамі	Adv
цяпер	цяпер	Adv
цяперака	цяперака	Adv
цярпіма	цярпіма	Adv
цярпліва	цярпліва	Adv
чадна	чадна	Adv
чакальна	чакальна	Adv
чалавечна	чалавечна	Adv
чапурыста	чапурыста	Adv
чарадзейна	чарадзейна	Adv
чарнюсенька	чарнюсенька	Adv
чароўна	чароўна	Adv
часова	часова	Adv
часткова	часткова	Adv
часцютка	часцютка	Adv
часцяком	часцяком	Adv
чахла	чахла	Adv
членараздзельна	членараздзельна	Adv
чуйна	чуйна	Adv
чула	чула	Adv
чулліва	чулліва	Adv
чутка	чутка	Adv
чутна	чутна	Adv
чутно	чутно	Adv
чуць	чуць	Adv
чынна	чынна	Adv
чыстасардэчна	чыстасардэчна	Adv
чысцюсенька	чысцюсенька	Adv
чысцютка	чысцютка	Adv
чытэльна	чытэльна	Adv
чэзла	чэзла	Adv
чэрства	чэрства	Adv
чэсна	чэсна	Adv
шаблонна	шаблонна	Adv
шагам	шагам	Adv
шалёна	шалёна	Adv
шапатліва	шапатліва	Adv
шапялява	шапялява	Adv
шарашом	шарашом	Adv
шаргатліва	шаргатліва	Adv
шкада	шкада	Adv
шкадліва	шкадліва	Adv
шкода	шкода	Adv
шкодна	шкодна	Adv
шляхетна	шляхетна	Adv
шмат	шмат	Adv
шматабяцальна	шматабяцальна	Adv
шматабяцаюча	шматабяцаюча	Adv
шматбакова	шматбакова	Adv
шматзначна	шматзначна	Adv
шматпланава	шматпланава	Adv
шматразова	шматразова	Adv
шматслоўна	шматслоўна	Adv
штовечар	штовечар	Adv
штогадзінна	штогадзінна	Adv
штогадзіны	штогадзіны	Adv
штогадова	штогадова	Adv
штогод	штогод	Adv
штогоду	штогоду	Adv
штодзённа	штодзённа	Adv
штодзень	штодзень	Adv
штодня	штодня	Adv
штодэкадна	штодэкадна	Adv
штоквартальна	штоквартальна	Adv
штолета	штолета	Adv
штомесяц	штомесяц	Adv
штомесячна	штомесячна	Adv
штоноч	штоноч	Adv
штоночы	штоночы	Adv
штопарам	штопарам	Adv
штораз	штораз	Adv
штораніцы	штораніцы	Adv
штосілы	штосілы	Adv
штосутачна	штосутачна	Adv
штотыдзень	штотыдзень	Adv
штотыднёва	штотыднёва	Adv
штохвілінна	штохвілінна	Adv
штохвіліны	штохвіліны	Adv
штучна	штучна	Adv
шумліва	шумліва	Adv
шурпата	шурпата	Adv
шчасна	шчасна	Adv
шчымліва	шчымліва	Adv
шчыра	шчыра	Adv
шчэ	шчэ	Adv
шыза	шыза	Adv
шырай	шырай	Adv
шырокавяшчальна	шырокавяшчальна	Adv
шэптам	шэптам	Adv
шэра	шэра	Adv
эвалюцыйна	эвалюцыйна	Adv
эгаістычна	эгаістычна	Adv
экалагічна	экалагічна	Adv
экзальтавана	экзальтавана	Adv
экзатычна	экзатычна	Adv
эклектычна	эклектычна	Adv
эксклюзіўна	эксклюзіўна	Adv
эксперыментальна	эксперыментальна	Adv
экспромтам	экспромтам	Adv
экспрэсіўна	экспрэсіўна	Adv
экстатычна	экстатычна	Adv
экстранна	экстранна	Adv
экстрэмальна	экстрэмальна	Adv
экстэнсіўна	экстэнсіўна	Adv
экстэрнам	экстэрнам	Adv
эксцэнтрычна	эксцэнтрычна	Adv
элегантна	элегантна	Adv
элегічна	элегічна	Adv
электраэнергетычна	электраэнергетычна	Adv
электрычна	электрычна	Adv
эмацыйна	эмацыйна	Adv
эмпірычна	эмпірычна	Adv
энергетычна	энергетычна	Adv
энцыклапедычна	энцыклапедычна	Adv
эпізадычна	эпізадычна	Adv
эпічна	эпічна	Adv
эскізна	эскізна	Adv
этнаграфічна	этнаграфічна	Adv
этнічна	этнічна	Adv
этымалагічна	этымалагічна	Adv
этычна	этычна	Adv
эфемерна	эфемерна	Adv
эфірна	эфірна	Adv
ювелірна	ювелірна	Adv
юзам	юзам	Adv
юрліва	юрліва	Adv
юрыдычна	юрыдычна	Adv
ядавіта	ядавіта	Adv
ядрана	ядрана	Adv
якраз	якраз	Adv
ялейна	ялейна	Adv
ярасна	ярасна	Adv
яршыста	яршыста	Adv
яўна	яўна	Adv
яшчэ	яшчэ	Adv

# Местоименные (TODO)

абы-адкуль	абы-адкуль	Adv
абы-дзе	абы-дзе	Adv
абы-калі	абы-калі	Adv
абы-куды	абы-куды	Adv
абы-як	абы-як	Adv
адгэтуль	адгэтуль	Adv
адкуль	адкуль	Adv
адкуль-небудзь	адкуль-небудзь	Adv
аднекуль	аднекуль	Adv
адсюль	адсюль	Adv
адтуль	адтуль	Adv
адусюль	адусюль	Adv
аніколі	аніколі	Adv
аніколькі	аніколькі	Adv
анічога	анічога	Adv
анічуць	анічуць	Adv
аніяк	аніяк	Adv
гдзе	гдзе	Adv
гэтак	гэтак	Adv
гэтаксама	гэтаксама	Adv
гэтулькі	гэтулькі	Adv
дагэтуль	дагэтуль	Adv
дакуль	дакуль	Adv
дасюль	дасюль	Adv
датуль	датуль	Adv
дзе	дзе	Adv
дзе-колечы	дзе-колечы	Adv
дзе-небудзь	дзе-небудзь	Adv
дзе-нідзе	дзе-нідзе	Adv
дзесь	дзесь	Adv
дзесьці	дзесьці	Adv
завошта	завошта	Adv
затым	затым	Adv
заўжды	заўжды	Adv
заўсёды	заўсёды	Adv
згэтуль	згэтуль	Adv
знекуль	знекуль	Adv
зусім	зусім	Adv
зусюль	зусюль	Adv
інакш	інакш	Adv
іначай	іначай	Adv
калі	калі	Adv
калі-небудзь	калі-небудзь	Adv
калі-нікалі	калі-нікалі	Adv
колечкі	колечкі	Adv
колісь	колісь	Adv
колькі-небудзь	колькі-небудзь	Adv
куды	куды	Adv
куды-небудзь	куды-небудзь	Adv
куды-нікуды	куды-нікуды	Adv
кудысь	кудысь	Adv
кудысьці	кудысьці	Adv
навошта	навошта	Adv
нагэтулькі	нагэтулькі	Adv
назаўжды	назаўжды	Adv
назаўсёды	назаўсёды	Adv
нашто	нашто	Adv
наштосьці	наштосьці	Adv
неадкуль	неадкуль	Adv
недзе	недзе	Adv
нейк	нейк	Adv
некалі	некалі	Adv
некуды	некуды	Adv
нешта	нешта	Adv
неяк	неяк	Adv
ніадкуль	ніадкуль	Adv
нідзе	нідзе	Adv
нізавошта	нізавошта	Adv
нізашто	нізашто	Adv
ніколечкі	ніколечкі	Adv
ніколі	ніколі	Adv
ніколькі	ніколькі	Adv
нікуды	нікуды	Adv
нічагусенькі	нічагусенькі	Adv
нічагуткі	нічагуткі	Adv
нічуць	нічуць	Adv
ніштавата	ніштавата	Adv
нішто	нішто	Adv
ніяк	ніяк	Adv
ніякавата	ніякавата	Adv
па-вашаму	па-вашаму	Adv
па-вашым	па-вашым	Adv
па-іншаму	па-іншаму	Adv
па-іхняму	па-іхняму	Adv
па-мойму	па-мойму	Adv
па-нашаму	па-нашаму	Adv
па-свойму	па-свойму	Adv
па-твойму	па-твойму	Adv
па-ўсякаму	па-ўсякаму	Adv
пакуль	пакуль	Adv
патуль	патуль	Adv
паўсюдна	паўсюдна	Adv
паўсюль	паўсюль	Adv
пачым	пачым	Adv
покуль	покуль	Adv
сам-насам	сам-насам	Adv
скуль	скуль	Adv
стуль	стуль	Adv
сюд-туд	сюд-туд	Adv
сюдой	сюдой	Adv
сюды	сюды	Adv
сюды-туды	сюды-туды	Adv
сягды-тагды	сягды-тагды	Adv
сяды-тады	сяды-тады	Adv
сяк-так	сяк-так	Adv
сям-там	сям-там	Adv
тагды	тагды	Adv
тады	тады	Adv
тады-сяды	тады-сяды	Adv
так	так	Adv
так-сяк	так-сяк	Adv
таксама	таксама	Adv
там	там	Adv
там-сям	там-сям	Adv
тамака	тамака	Adv
таму	таму	Adv
туд-сюд	туд-сюд	Adv
туды	туды	Adv
туды-сюды	туды-сюды	Adv
тудэю	тудэю	Adv
усюды	усюды	Adv
усяго	усяго	Adv
усяк	усяк	Adv
усяляк	усяляк	Adv
тут	тут	Adv
тутака	тутака	Adv
чаго	чаго	Adv
чаго-небудзь	чаго-небудзь	Adv
чагось	чагось	Adv
чагосьці	чагосьці	Adv
чаму	чаму	Adv
чаму-небудзь	чаму-небудзь	Adv
чамусь	чамусь	Adv
чамусьці	чамусьці	Adv
як-колечы	як-колечы	Adv
як-небудзь	як-небудзь	Adv
як-ніяк	як-ніяк	Adv
